aachen	Аахен
valog	Валог
abaza	Абаза
aberdeen	Абърдийн
abidjan	Абиджан
terter	Тертер
stolut	Столът
ablanitsa	Абланица
abrit	Абрит
abuja	Абуджа
accra	Акра
adelaide	Аделейд
agadir	Агадир
agatovo	Агатово
agerola	Аджерола
aglen	Ъглен
agri	Агръ
aix-en-provence	Екс ан Прованс
aix-les-bains	Екс ле Бен
zheglarci	Жегларци
akandzhievo	Аканджиево
akatsievo	Акациево
akheloj	Ахелой
akheloy	Ахелой
akhladhea	Блатчен
akhladhokhorion	Крушево
akhmatovo	Ахматово
akhrjansko	Ахрянско
akhryansko	Ахрянско
voden	Воден
akranes	Акранес
aksakovo	Аксаково
aksum	Аксум
alabama	Алабама
tsokevtsi	Цокевци
alamovtsi	Аламовци
alar	Алар
alaska	Аляска
albantsi	Албанци
tumbevtsi	Тумбевци
albena	Албена
albinea	Албинеа
albino	Албино
albuquerque	Албакърки
alcek	Алцек
aldomirovci	Алдомировци
aldomirovtsi	Алдомирци
aleko-konstantinovo	Алеко-Константинов
alekovo	Алеково
venets	Венец
vidrar	Видрар
aleksandrow	Александров
alekseevo	Алексеево
yuper	Юпер
alessandria	Алесандрия
alexandria	Александрия
alexandroupolis	Александруполис
somovit	Сомовит
algeciras	Алхесирас
algiers	Алжир
aligovska	Алиговска
alino	Алино
alloa	Алоа
almaty	Алмати
almeria	Алмерия
al'ovgrob	Альовгроб
altimir	Алтимир
altsek	Алцек
alvanovo	Алваново
amalfi	Амалфи
amboise	Амбоаз
vasilovci	Василовци
taymishte	Таймище
amsterdam	Амстердам
anaheim	Анахайм
anchorage	Анкоридж
andalucia	Андалусия
vokil	Вокил
strazhets	Стражец
sukhodol	Суходол
angelarij	Ангеларий
angelariy	Ангеларий
angelov	Ангелов
angelovo	Ангелово
angers	Анже
angistron	Сенгельово
anguilla	Ангуила
ankara	Анкара
antalya	Анталия
antananarivo	Антананариво
antarctica	Антарктида
antimovo	Антимово
antioch	Антакия
antofagasta	Антофагаста
zetjovo	Зетьово
antonovo	Антоново
antwerpen	Антверпен
aosta	Аоста
aplatsi	Аплаци
aprica	Априка
aprilci	Априлци
sredec	Средец
zemen	Земен
aqaba	Акаба
arad	Арад
arbanasi	Арбанаси
archar	Арчар
umarevci	Умаревци
arda	arda
yambol	Ямбол
velichkovo	Величково
arhus	Орхус
arica	Арика
arizona	Аризона
arkansas	Арканзас
arkona	Аркона
tukhovishta	Туховища
arles	Арл
arlington	Арлингтън
armenite	Армените
surnica	Сърница
arnautito	Арнаутино
arnhem	Арнем
arona	Арона
arpadzhik	Арпаджик
yonkovo	Йонково
stoykite	Стойките
arzan	Арзан
asen	Асен
asenovci	Асеновци
asenovec	Асеновец
asenovets	Асеновец
asenovgrad	Асеновград
asenovo	Асеново
trem	Трем
ashgabat	Ашхабад
telish	Телиш
asparukhovo	Аспарухово
zhilentsi	Жиленци
assisi	Асизи
astana	Астана
telcharka	Телчарка
asuncion	Асунсион
aswan	Асуан
atanasovo	Атанасово
athens	Атина
srednogortsi	Средногорци
temnisko	Темнишко
atolovo	Атолово
atrani	Атрани
zagorsko	Загорско
auch	Ош
auckland	Окланд
austa	Ауста
austin	Остин
avarua	Аваруа
avignon	Авиньон
avramovo	Аврамово
avramovska	Аврамовска
avren	Аврен
aydarovo	Айдарово
aydemir	Айдемир
aydin	Айдън
yazovets	Язовец
aytos	Айтос
azmanite	Азманите
baalbek	Баалбек
stoevtsi	Стоевци
babinci	Бабинци
babino	Бабино
spakhievo	Спахиево
zmeitsa	Змеица
vrudlovtsi	Връдловци
zimovina	Зимовина
babovo	Бабово
babruysk	Бобруйск
babuk	Бабук
babyak	Бабяк
weimar	Ваймар
bachevo	Бачево
bachiishte	Бачище
bachkovo	Бачково
baden-wuerttemberg	Баден-Вюртемберг
badevtsi	Бадевци
badino	Бадино
baevtsi	Баевци
vsemirtsi	Всемирци
baghdad	Багдад
bagra	Багра
bagrenci	Багренци
bagrentsi	Багренци
bagrilci	Багрилци
utrecht	Утрехт
bagrjanka	Багрянка
bagryanka	Багрянка
bajachevo	Баячево
tsaparevo	Цапарево
bajkovo	Байково
bajlovo	Байлово
bakalite	Бакалите
bakersfield	Бейкърсфилд
bakhalin	Бахалин
bakhovica	Баховица
bakhovitsa	Баховица
bakhretsi	Бахреци
bak'ovo	Бакьово
baku	Баку
balabanchevo	Балабанчево
balabanovo	Балабаново
balabanska	Балабанска
balabansko	Балабанско
balaleya	Балалея
balanite	Баланите
balanovo	Баланово
balantsite	Баланците
balchik	Балчик
baldevo	Балдево
balej	Балей
baley	Балей
balik	Балик
zvezden	Звезден
balintsovo	Балинцово
balkanets	Балканец
balkan	Балкан
balkanski	Балкански
balkantsi	Балканци
balkh	Балх
bal'ovtsi	Бальовци
svirchovo	Свирчово
balti	Белци
baltimore	Балтимор
sukholoevtsi	Сухолоевци
balvan	Балван
balvantsite	Балванците
balyuvitsa	Балювица
sredkovets	Средковец
bamberg	Бамберг
banari	Банари
banchovtsi	Банчовци
banevo	Банево
bangeytsi	Бангейци
zhultusha	Жълтица
zhelen	Желен
banica	Баница
tournai	Турне
staykovtsi	Стайковци
baniska	Баниска
banite	Баните
banitsa	Баница
banja	Баня
bankovets	Банковец
bankovtsi	Банковци
sredna	Средна
banovo	Баново
bansko	Банско
banya	Баня
ba`qubah	Бакуба
baracoa	Баракоа
barakhelite	Барачелите
barakovo	Бараково
baranavichy	Барановичи
vaksevo	vaksevo
baratsi	Бараци
tsenovtsi	Ценовци
barcelona	Барселона
wadowice	Вадовице
bar	Бар
barranquilla	Баранкиля
barutin	Барутин
basarbovo	Басарбово
suevtsi	Суевци
basel	Базел
bashevo	Башево
bashhino	Бащино
bashtino	Бащино
baskaltsi	Баскалци
batak	Батак
bata	Бата
batanovci	Батановци
batanovtsi	Батановци
batantsi	Батанци
batin	Батин
vladimirovo	Владимирово
batishnitsa	Батишница
batkovtsi	Батковци
batkun	Баткун
batoshevo	Батошево
batovo	Батово
batuliya	Батулия
batultsi	Батулци
bat'umi	Батуми
baurene	Баурене
bautzen	Бауцен
bayachevo	Байчево
bayamon	Баямон
voynezha	Войнежа
baykalsko	Байкалско
baykovo	Байково
baylovo	Байлово
bayonne	Байон
waterbury	Уотърбъри
bayovtsi	Байовци
bayreuth	Байройт
venchan	Венчан
vidlitsa	Видица
bebrovo	Беброво
beden	Беден
bedil	Бедил
bedrovo	Бедрово
stracin	Страцин
beersheba	Беер Шева
beglezh	Беглеж
vetren	Ветрен
begovo	Бегово
begunci	Бегунци
begunovtsi	Бегуновци
beguntsi	Бегунци
beijing	Пекин
beirut	Бейрут
bekriite	Бекриите
srebroto	Среброто
belashhica	Белащица
belashtitsa	Белащница
belasica	Беласица
belasitsa	Беласица
srednogorci	Средногорци
belchin	Белчин
belcov	Белцов
belega	Белега
belenci	Беленци
belene	Белене
belentsi	Беленци
stroevo	Строево
belevren	Белеврен
belfast	Белфаст
spasovo	Спасово
belgun	Белгун
topolovec	Тополовец
stavanger	Ставангер
belila	Белила
belimel	Белимел
zmejovo	Змейово
belintsi	Белинци
syanovo	Сяново
belitsa	Белица
belize	Белиз
beljakovec	Беляковец
varnentsi	Варненци
belmopan	Белмопан
belodol	Белодол
belogradchik	Белоградчик
belogradec	Белоградец
belogradets	Белоградец
beloklas	Белоклас
belokopitovo	Белокопитово
belomorci	Беломорци
belomortsi	Беломорци
belomuzhite	Беломъжите
belopolci	Белополци
belopoltsi	Белополци
belopolyane	Белополяне
belopopci	Белопопци
belopoptsi	Белопопци
beloptichene	Белоптичене
vinitsa	Виница
belotinci	Белотинци
belotintsi	Белотинци
belovec	Беловец
belovets	Беловец
belovica	Беловица
belovitsa	Беловица
belovo	Белово
bel'ovo	Бельово
belozem	Белозем
beltsov	Белцов
belyakovets	Беляковец
belyanovets	Беляновец
belyanovo	Беляново
bengalore	Бангалор
benghazi	Бенгази
benkovski	Бенковски
berayntsi	Берайнци
berende	Беренде
bergama	Бергама
bergamo	Бергамо
bergen	Берген
berievo	Бериево
berkeley	Бъркли
ugoryalkovtsi	Угорялковци
berkovski	Берковски
yovchevtsi	Йовчевци
berlin	Берлин
bermuda	Бермудски о-ви
zlatosel	Златосел
beronovo	Бероново
yasenite	Ясените
tsvetino	цветино
beslen	Беслен
velislav	Велислав
bethune	Бетюн
beykovtsi	Бейковци
bezdenica	Безденица
bezden	Безден
bezhanovo	Бежаново
bezhantsi	Бежанци
veles	Велес
bezvodica	Безводица
bezvoditsa	Безводица
bezvodno	Безводно
bialystok	Бялисток
yarebichno	Яребично
bilbao	Билбао
bilintsi	Билинци
bilka	Билка
bilkini	Билкини
zlatopole	Златополе
bilo	Било
bilyanska	Билянска
bilyartsi	Билярци
binche	Бенш
zoychene	Зоичене
stambolijski	Стамболийски
vergina	Кутлеш
birmingham	Бирмингам
biserci	Бисерци
biser	Бисер
bisertsi	Бисерци
bishkek	Бишкек
bismarck	Бисмарк
bistra	Бистра
bistrec	Бистрец
bistrenci	Бистренци
bistrentsi	Бистренци
strumeshnica	Струмешница
bistrica	Бистрица
bistrilitsa	Бистрилица
vetrintsi	Балван махала
bistritsa	Бистрица
bistrogled	Бистроглед
bitola	Битоля
bivolare	Биволаре
bivoljane	Биволяне
zhabokrut	Жабокрът
bivolyane	Биволяне
usoyka	Усойка
bjaga	Бяга
bjala	Бяла
blagoevgrad	Благоевград
blagoevo	Благоево
blagovets	Благовец
blagovo	Благово
blagun	Благун
tsvyatkovtsi	Цвятковци
blateshnitsa	Блатешница
blatets	Блатец
blatino	Блатино
blatnitsa	Блатница
blato	Блато
blatoto	Блатото
topoli	Тополи
blazhievo	Блажиево
blenika	Бленика
blera	Блера
blgarene	Българене
bliznaci	Близнаци
bliznak	Близнак
bliznatsi	Близнаци
bliznets	Близнец
bloemfontein	Блумфонтейн
bluskovo	Блъсково
sovolyano	Соволяново
boazut	Боазъ
bobeshino	Бобешино
bobevtsi	Бобевци
boblingen	Бьоблинген
boboratsi	Бобараци
boboshevo	Бобочево
bobovdol	Бобовдол
struja	Струя
bochkovtsi	Бошковци
bodenec	Боденец
bodenets	Боденец
zaka	Зака
bodrovtsi	Бодровци
bodrum	Бодрум
zabel	Забел
boeritsa	Боерица
zhitnitsa	Житница
boevska	Боевска
starchishte	Старчище
bogatino	Богатино
bogatovo	Богатово
uzunovo	Узуново
bogdanci	Богданци
bogdanica	Богданица
bogdanitsa	Богданица
bogdan	Богдан
bogdanliya	Богданлия
bogdanovdol	Богдановдол
bogdanovo	Богданово
bogdanovtsi	Богдановци
trivodici	Триводици
bogdantsi	Богданци
bogoina	Боголина
bogolin	Боголин
bogolonta	Боголотна
zagore	Загоре
bogomil	Богомил
bogomilovo	Богомилово
bogomiltsi	Богомилци
bogomolsko	Богомолско
bogorovo	Богорово
stareyshino	Старейшино
bogota	Богота
sredoselci	Средоселци
bogutevo	Богутево
boil	Боил
bojadzhik	Бояджик
bojana	Бояна
bojanci	Боянци
vurlishte	Върлище
bojanovo	Бояново
bojno	Бойно
bokhot	Бохот
bokhova	Бохова
yan'ovets	Яновец
boljarci	Болярци
boljarino	Болярино
boljarsko	Болярско
bologna	Болоня
boltata	Болтата
bolyarino	Болярово
bolyarovo	Болярово
svoboden	Свободен
bolyartsi	Болярци
voynitsite	Войниците
bonevo	Бонево
bonn	Бон
borci	Борци
bordeaux	Бордо
vitevtsi	Витевци
boren	Борен
zhiten	Житен
trakiya	Тракия
borieva	Бориева
borika	Борика
boriki	Борики
borikovo	Бориково
borilovec	Бориловец
borilovets	Бориловец
borilovo	Борилово
trave	Траве
borimechkovo	Боримечково
borino	Борино
turiya	Турия
borintsi	Боринци
borislavci	Бориславци
svidnya	Свидня
borislavtsi	Бориславци
borisovo	Борисова
borjana	Боряна
borjomi	Боржоми
bor	Бор
bormio	Бормио
bornarevo	Борнарево
sydney	Сидни
borovci	Боровци
borovets	Боровец
borovica	Боровица
borovichene	Боровичене
borovina	Боровина
tataritsa	Татарица
vladimirovci	Владимировци
zaverdentsi	Заверденци
borovsko	Боровско
borovtsi	Боровци
borskoto	Борското
bortsi	Борци
borushtitsa	Борущица
boryana	Боряна
bosevtsi	Босевци
boshulja	Бошуля
turnyane	Търняне
bosilegrad	Босилеград
bosilek	Босилек
yasenkovo	Ясенково
bosilkovci	Босилковци
bosilkovo	Босилково
bosilkovtsi	Боликовци
troskovo	Тросково
bosnek	Боснек
tucson	Тюсон
bostan	Бостан
srednogorovo	Средногорово
tomchevtsi	Томчевци
boston	Бостън
botevgrad	Ботевград
urovene	Уровене
botosani	Ботошани
botrov	Ботров
botunets	Ботунец
voyvoda	Войвода
boturche	Ботурче
bov	Бов
boyadzhieva	Бояджиева
szczecin	Шчечин
boyana	boyana
boyan-botevo	Боян-Ботево
boyan	Боян
boyanovo	Бояново
boyanovtsi	Бояновци
boyantsi	Боянци
boycheta	Бойчета
vievo	Виево
boychovskoto	Бойчовското
boychovtsi	Бойчовци
boykata	Бойката
boykovets	Бойковец
boykovo	Бойково
boykovtsi	Бойковци
boymir	Боймир
boynik	Бойник
boynitsa	Бойница
boyno	Бойно
boynovtsi	Бойновци
bozadzhii	Бозаджии
bozduganovo	Боздуганово
bozhak	Божак
bozhan	Божан
bozhanovo	Божаново
vojvodinovo	Войводиново
bozhenitsa	Боженица
bozhentsi	Боженци
bozhevci	Божевци
bozhevtsi	Божевци
bozhichen	Божичен
bozhitsa	Божица
bozhkovtsi	Божковци
bozhurets	Божурец
bozhurica	Божурица
voynikovo	Войниково
bozhuritsa	Божурица
bozhurka	Божурка
bozhurluk	Божурлук
bozhurovo	Божурово
bozhurtsi	Божурци
bozirog	Бозирог
boztas	Керациново
sub'ovska	Събовска
bozveliysko	Бозвелийско
bradvari	Брадвари
braila	Браила
braknitsa	Бракница
brak'ovtsi	Бракьовци
bra	Бра
vazovo	Вазово
branichevo	Браничево
branipole	Браниполе
branishhe	Бранище
branishte	Бранище
tsarichina	Царичина
brankovtsi	Бранковци
brasov	Брашов
bratanica	Братаница
bratanitsa	Братаница
bratan	Братан
torun	Торун
bratislava	Братислава
bratovo	Братово
bratsigovo	Брацигово
bratushkovo	Братушкови
braykovitsa	Брайковица
breda	Бреда
bregare	Брегаре
bregovo	Брегово
yastreb	Ястреб
brenica	Бреница
brenitsa	Бреница
brestaka	Брестака
znamenosec	Знаменосец
breste	Бресте
brest	Брест
brestnica	Брестница
brestnik	Брестник
brestnitsa	Брестница
brestova	Брестова
brestovec	Брестовец
vresovo	Вресово
yankovtsi	Янковци
brestovica	Брестовица
zverino	Зверино
brestovo	Брестово
breza	Бреза
breze	Брезе
brezen	Брезен
stockton	Стоктън
brezhnitsite	Брежниците
breznica	Брезница
breznik	Брезник
breznitsa	Брезница
ustrem	Устрем
brezovo	Брезово
brig	Бриг
brisbane	Бризбейн
bristol	Бристъл
brjagovica	Бряговица
brjagovo	Брягово
sovoljano	Соволяно
strazhec	Стражец
brodilovo	Бродилово
brod	Брод
bronx	Бронкс
brooklyn	Бруклин
brosh	Брош
stanchevo	Станчево
bruchma	Бръчма
brugge	Брюж
brunate	Брунате
brunetsite	Брънеците
brunkovtsi	Брънковци
brusartsi	Брусарци
vurbeshnitsa	Върбешница
brusevtsi	Брусевци
brushhen	Бръщен
tolovitsa	Толовица
vurteshevo	Въртешево
swansea	Суонзи
brushlyan	Бръшлян
brushten	Бръщен
brusino	Брусино
brusnik	Брусник
brussels	Брюксел
bryag	Бряг
bryagovets	Бряговец
bryagovitsa	Бряговица
bryagovo	Брягово
bryast	Бряст
bryastovets	Брястовец
bryastovo	Брястово
turun	Търън
bucaramanga	Букараманга
tikhomir	Тихомир
bucharest	Букурещ
buchevarite	Бъчеварите
buchino	Бучино
buchukovtsi	Бучуковци
budapest	Будапеща
veselinovo	Веселиново
budeshte	Бъдеще
stankovo	Станково
budva	Будва
versko	Верско
bujnovica	Буйновица
bujnovo	Буйново
zavoja	Завоя
wiesbaden	Висбаден
bukhovci	Буховци
bukhovo	Бухово
srebrinovo	Сребриново
buk	Бук
bukorovtsi	Букоровци
bukovec	Буковец
bukovets	Буковец
bukovluk	Буковлък
bukovo	Буково
bukvar	Буквар
bulair	Булаир
toano	Тоано
bulgarchevo	Българчево
zamfirovo	Замфирово
zgorigrad	Згориград
bulgari	Българи
bulgarin	Българин
zhivko	Живко
bulgarovo	Българово
strelec	Стрелец
bunovo	Буново
buntsevo	Бунцево
bunzareto	Бънзарето
buranovo	Бураново
burbank	Бърбанк
burchevo	Бърчево
vubbel	Въбел
burdarite	Бърдарите
burdeni	Бърдени
burdokva	Бърдоква
burdo	Бърдо
burduche	Бърдуче
burevo	Бурево
burgas	Бургас
burgenland	Бургенланд
burgos	Бургос
burja	Буря
burkachevo	Бъркачево
burkach	Бъркач
burlozhnitsa	Бърложница
burlya	Бърля
tirana	Тирана
topolovets	Тополовец
burzija	Бързия
burzina	Бързина
burzitsa	Бързица
burziya	Бързия
busintsi	Бусинци
zagortsi	Загорци
busmantsi	Бусманци
buta	Бъта
butan	Бутан
butovo	Бутово
butreva	Бутрева
butrointsi	Бутроинци
vrachantsi	Врачанци
varnik	Варник
buynovo	Буйново
buynovtsi	Буйновци
buzau	Бузъу
buzovec	Бъзовец
buzovets	Бъзовец
buzovgrad	Бузовград
buzovitsa	Бъзовица
buzun	Бъзън
buzyakovtsi	Бузяковци
byaga	Бяга
byala	Бяла
velichka	Величка
byalkovo	Бялково
byalkovtsi	Бялковци
bydgoszcz	Бидгошч
varna	Варна
caen	Кан
cagnes-sur-mer	Кан сюр Мер
cahul	Кахул
cairo	Кайро
zlatograd	Златоград
calcutta	Калкута
caldogno	Калдоньо
calgary	Калгари
cali	Кали
callao	Каляо
calw	Калв
camaguey	Камагуей
cambridge	Кеймбридж
camogli	Камоли
canada	Канада
canberra	Канбера
candela	Кандела
voyvodovo	Войводово
zhablyano	Жабляно
capri	Капри
caracas	Каракас
caracovo	Царацово
carevci	Царевци
vranentsi	Враненци
carimir	Царимир
vishna	Вишна
wellington	Уелингтън
usojka	Усойка
casablanca	Казабланка
sredets	Средец
catak	Читак
strakhilovo	Страхилово
celina	Целина
tukach	Тъкач
cernavoda	Черна вода
cerovishhe	Церовище
cerovo	Церово
cesaro	Чезаро
cesena	Чезена
cetara	Четара
cetinje	Цетине
ceuta	Сеута
ceva	Чева
chajka	Чайка
chakalarovo	Чакаларово
chakalci	Чакалци
zhitosvyat	Житосвят
zajchar	Зайчар
surnets	Сърнец
chala	Чала
tiksi	Тикси
chalukovi	Чалъкови
voursiani	Връщен
champaign	Шампейн
chapaevo	Чапаево
charda	Чарга
terziysko	Терзийско
charkovete	Чарковете
charkovo	Чарково
vranje	Враня
charlotte	Шарлът
chavdarci	Чавдарци
yerusalimovo	Ерусалимово
chavdartsi	Чавдарци
chavei	Чавеи
tsvyatovo	Цвятово
chayka	Чайка
vrabets	Врабец
tsarevo	Царево
chekanets	Чеканец
chekantsi	Чеканци
trunak	трънак
chekhlari	Чехлари
chekhlyuvtsi	Чеклювци
chelnik	Челник
chelopechene	Челопечене
chelopech	Челопеч
chelopek	Челопек
chelyabinsk	Челябинск
chelyustnitsa	Челъстница
chemersko	Чемерско
chemish	Чемиш
chemnitz	Кемниц
vubel	Въбел
chepelare	Чепеларе
svoboda	Свобода
chepino	Чепино
chepintsi	Чепинци
chepleten	Чеплетен
chepurlintsi	Чепърлинци
cherencha	Черенка
cherepovo	Черепово
vidintsi	Видинци
chereshica	Черешица
chereshitsa	Черешица
tsirka	Цирка
chereshnitsa	Черешница
chereshovitsa	Черешовица
chereshovo	Черешово
cherganovo	Черганово
tushovtsa	Тушовца
cherkovica	Черковица
cherkovishte	Черковище
vurbina	Върбина
staynovtsi	Стайновци
tamarino	Тамарино
zavetno	Заветно
chernalevo	Черналево
struga	Струга
chernevoto	Черневото
chernevtsi	Черневци
chernica	Черница
cherniche	Черниче
chernichevo	Черничево
chernichino	Черничино
chernigovo	Чернигово
chernik	Черник
chernitsa	Черница
chernodub	Чернодъб
chernoglavci	Черноглавци
chernoglavtsi	Черноглавци
chernogor	Черногор
chernogorovo	Черногорово
yavrovo	Яврово
chernokapci	Чернокапци
chernokaptsi	Чернокарци
zavoj	Завой
chernokos	Чернокос
chernolik	Чернолик
chernomorec	Черноморец
chernomorets	Черноморец
chernomortsi	Черноморци
vodnyantsi	Воднянци
chernooki	Чернооки
chernook	Черноок
chernookovo	Чернооково
chern'ovo	Черньово
yavornitsa	Яворница
chern'ovtsi	Черньовци
chernozemen	Черноземен
chernozem	Чернозем
chernushka	Чернушка
vurshets	Вършец
chervena	Червена
sotuchino	Сотучино
vlasatitsa	Власатица
tuvalu	Тувалу
cherventsi	Червенци
cheshlyantsi	Чешлянци
cheshma	Чешма
cheshnegirovo	Чешнегирово
chester	Честър
chestimensko	Честименско
yunatsite	Юнаците
chetirtsi	Четирци
chetroka	Четрока
chibaovci	Чибаовци
chibaovtsi	Чибаовци
chicago	Чикаго
chichevo	Чичево
topuzi	Топузи
chiflika	Чифлика
chiflik	Чифлик
chilik	Чилик
chilnov	Чилинов
chintulovo	Чинтулово
chiprovtsi	Чипровци
chiren	Чирен
chirpan	Чирпан
trustikovo	Тръстиково
chistovo	Чистово
chitakovtsi	Читаковци
chitashko	Читашко
choba	Чоба
chobanka	Чобанка
chokmanovo	Чокманово
chokoba	Чокоба
cholakova	Чолакова
cholakovtsi	Чолаковци
stezherovo	Стежерово
chomakovo	Чомаково
chomakovtsi	Чомаковци
chongqing	Чунцин
chorbadzhijsko	Чорбаджийско
chorbadzhiysko	Чорбаджийско
chorlevo	Чорлево
chornobyl'	Чернобил
chorul	Чорул
zhitusha	Житуша
chubra	Чубра
chubrika	Чубрика
chuchan	Чучан
chuchuliga	Чучулига
chuchuligovo	Чучулигово
chuchur	Чучур
chudintsi	Чудинци
solishta	Солища
chukarka	Чукарка
chukarovo	Чукарово
varovnik	Варовник
chukilite	Чукилите
chuklenik	Чукленик
chukovec	Чуковец
uscio	Ушо
chukovezer	Чуковезер
chukovo	Чуково
vlakhovo	Влахово
chuprene	Чупрене
churek	Чурек
churen	Чурен
churicheni	Чуричени
churilovo	Чурилово
churka	Чурка
chur	Кур
trudovets	Трудовец
chuypetlovo	Чуйпетльово
cincinnati	Синсинати
clermont-ferrand	Клермон Феран
cleveland	Кливланд
tvurdinci	Твърдинци
cluses	Клюз
tetovo	Тетово
colchester	Колчестър
verizhari	Верижари
tallinn	Талин
colorado	Колорадо
columbia	Колумбия
verdikal	Вердикал
como	Комо
comrat	Комрат
conakry	Конакри
concord	Конкорд
waterloo	Ватерло
strelci	Стрелци
constanta	Констанца
copenhagen	Копенхаген
cordoba	Кордоба
cork	Корк
corleone	Корлеоне
corpus	Корпус
correggio	Кореджо
corrientes	Кориентес
corvallis	Корвалис
cottbus	Котбус
craiova	Крайова
cremona	Кремона
crewe	Крю
cruncha	Црънча
cucuta	Кукута
cupertino	Купертино
curkva	Църква
curkvica	Църквица
curkvishhe	Църквище
cusco	Куско
tatkovo	Татково
dabok	Дабок
dachau	Дахау
daevtsi	Даевци
dafinintsi	Дафинци
dagonovo	Дагоново
dahuk	Дахук
dallas	Далас
sulitsa	Сулица
trapeskovtsi	Трапесковци
damjanica	Дамяница
damjanovo	Дамяново
damme	Даме
damyanitsa	Дамяница
titevtsi	Титевци
danailovo	Данаилово
tryavna	Трявна
svoge	Своге
vodenicharovo	Воденичарско
darmstadt	Дармщат
darovitsa	Даровица
daskal-atanasovo	Даскал-Атанасово
daskalovo	Даскалово
daugavpils	Даугавпилс
daveri	Давери
davidkovo	Давидково
davidovo	Давидово
davis	Дейвис
daynovtsi	Дейновци
debar	Дебър
debelec	Дебелец
debelets	Дебелец
zittau	zittau
debeltsovo	Дебелцово
debelyanovo	Дебеляново
vrakupovitsa	Вракоповица
debochitsa	Дебочица
debovo	Дебово
debrashtitsa	Дебращница
debrecen	Дебрецен
debrene	Дебрене
debren	Дебрен
yarlovtsi	Ярловци
dechkovtsi	Дечковци
dedets	Дедец
dedina	Дедина
staychovtsi	Стайчовци
dedovo	Дедово
deggendorf	Дегендорф
dekov	Деков
suedinenie	Съединение
delchevo	Делчево
delejna	Делейна
svirachi	Свирачи
delft	Делфт
vrabcha	Врабча
delidzhetsite	Делиджеците
delvino	Делвино
delyan	Делян
delyanovtsi	Деляновци
tiraspol	Тираспол
dennitsa	Денница
denver	Денвър
derikotkovtsi	Дерикотковци
dermanci	Дерманци
dermantsi	Дерманци
deskot	Дъскот
dessau	Десау
detelina	Детелина
detroit	Детройт
tikhomirovo	Тихомирово
devenci	Девенци
devene	Девене
deventsi	Девенци
devesilitsa	Девесилица
devesilovo	Девесилово
yardzhilovtsi	Ярджиловци
vinishte	Винище
devetatsite	Деветаците
devetintsi	Деветинци
devin	Девин
devino	Девино
devnya	Девня
dhelfoi	Делфи
dhelta	Витово
dhiplokhori	Дъблен
diamandovo	Диамандово
dibich	Дибич
dichevo	Дичево
dichin	Дичин
dijon	Дижон
tsarevets	Царевец
dimanovtsi	Димановци
vezenkovo	Веженково
dimchevo	Димчево
dimievtsi	Димиевци
dimitrievo	Димитриево
dimitrovche	Димитрикьой
vrazhdebna	Враждебна
dimitrovtsi	Димитровци
vurbovka	Върбовка
dimovo	Димово
dimovtsi	Димовци
dinevo	Динево
dinkata	Динката
dink	Динк
dinkovitsa	Динковица
dinkovo	Динково
dinya	Диня
diralo	Дирало
disevica	Дисевица
yoren	Йорен
dismanitsa	Дисманица
divchovoto	Дивчовото
divdyadovo	Дивдядово
vishan	Вишан
divlya	Дивля
divotino	Дивотино
vranintsi	Вранинци
turgovishte	Търговище
djadovsko	Дядовско
djakovo	Дяково
topolovgrad	Тополовград
djenne	Джене
djulevo	Дюлево
zherka	Жерка
djulino	Дюлино
dlugnevo	Длъгнево
vurbitsa	Върбица
dluzhko	Длъжко
dmitrov	Дмитров
doborsko	Доборско
dobraluk	Добралък
virovsko	Вировско
voyno	Войно
dobrevci	Добревци
dobrevo	Добрево
dobrevtsi	Добревци
dobrich	Добрич
dobrina	Добрина
dobrinci	Добринци
dobrinishhe	Добринище
dobrinishte	Добринище
dobrin	Добрин
dobrinovo	Добриново
dobrintsi	Добринци
dobrodan	Добродан
tipchenica	Типченица
dobrolevo	Добролево
dobromirci	Добромирци
dobromirka	Добромирка
dobromir	Добромир
vranyantsi	Вранянци
yablanitsa	Ябланица
dobroselets	Доброселец
vis	Вис
dobroslavtsi	Доброславци
dobrostan	Добростан
dobrotica	Добротица
dobrotich	Добротич
dobrotino	Добротино
dobrotitsa	Добротица
dobrovnica	Добровница
dobrovnitsa	Добровница
dobrovo	Доброво
dobrovolets	Добровец
dobrudzhanka	Добруджанка
dobrusha	Добруша
tutrakan	Тутракан
dobursko	Добърско
staroselets	Староселец
yaka-badzha-k'oy	Яка-Баджа-Кьой
subotica	Суботица
dojranci	Дойранци
vojnika	Войника
dokatichevo	Докатичево
turkincha	Туркинча
dolapite	Долапите
dolare	Доларе
dolboka	Дълбоки
dolec	Долец
dolene	Долене
doleni	Долени
dolen	Долен
dolets	Долец
dolie	Долие
dolina	Долина
turija	Турия
vekhtino	Вехтино
dolnoseltsi	Долноселци
taba	Таба
vardo	Вардьо
domishhe	Домище
domishte	Домище
domljan	Домлян
domlyan	Домлян
zlokuchene	Злокучене
zheljava	Желява
vorarlberg	Форарлберг
donino	Донино
donkino	Донкино
donkovtsi	Донковци
dorkovo	Дорково
dorl'ovtsi	Дорльовци
tombeto	Томбето
dospat	Доспат
dospej	Доспей
dospey	Доспей
douai	Дуе
douala	Дуала
doykintsi	Дойкинци
doynovtsi	Дойновци
doyrantsi	Дойранци
doyrentsi	Дойренци
dozhdevitsa	Дождевица
drabishna	Драбишна
drachevo	Драчево
dragalevtsi	dragelevtsi
dragalina	Драгалина
dragana	Драгана
tupchileshtovo	Тъпчилещово
draganica	Драганица
draganitsa	Драганица
stamford	Стамфорд
draganovci	Драгановци
vodoley	Водолей
draganovets	Драгановец
draganovo	Драганово
draganovtsi	Драгановица
dragantsi	Драганци
vologarska	Вологарска
dragievtsi	Драгиевци
toros	Торос
dragiovtsi	Драгиовци
dragiytsi	Драгийци
dragizhevo	Драгижево
dragnevska	Драгневска
dragnevtsi	Драгневци
dragodan	Драгодан
dragodanovo	Драгоданово
dragoevo	Драгоево
dragoil	Драгоил
turnak	Търнак
dragojnovo	Драгойново
dragolevtsi	Драголевци
zvezdec	Звездец
dragoman	Драгоман
dragomir	Драгомир
dragomirovo	Драгомирово
dragomuzh	Драгомъж
dragor	Драгор
dragostin	Драгостин
dragotintsi	Драготинци
dragovishhica	Драговищица
dragovishtitsa	Драговищица
svetulka	Светулка
dragovtsi	Драговци
dragoychintsi	Драгойчинци
zanoge	Заноге
dragushinovo	Драгушиново
varishte	Варище
draka	Драка
drakata	Драката
tsreshnovo	Црешново
drama	Драма
drandarite	Драндарите
stavretsite	Ставреците
turpan	Турфан
tsurkvino	Църквино
drazhevo	Дражево
drazhinci	Дражинци
drazhintsi	Дражинци
dreatin	Дреатин
drenci	Дренци
drenkovo	Дренково
dren	Дрен
drenovec	Дреновец
venelin	Венелин
drenovitsa	Дреновица
drenov	Дренов
drenovo	Дреново
drenta	Дрента
drentsi	Дренци
dresden	Дрезден
drinovo	Дриново
dripchevo	Дрипчево
dripka	Дрипка
drjanka	Дрянка
drjanovec	Дряновец
drjanovo	Дряново
drogheda	Дроида
dropla	Дропла
drugan	Друган
drumche	Друмче
zornica	Зорница
drumokhar	Друмохар
drumsha	Дръмша
tyanevo	Тянево
drundarska	Дръндарска
druvnitsa	Дръвница
druzhba	Дружба
druzhevo	Дружево
tuchenitsa	Тученица
dryanka	Дрянка
strasbourg	Страсбург
dryanovets	Дряновец
dryanovo	dryanovo
dryanska	Дрянска
dryanut	Дрянът
dubai	Дубай
dubene	Дъбене
duben	Дъбен
dub	Дъб
ulaanbaatar	Улан Батор
dubnica	Дъбница
dubnik	Дъбник
dubnitsa	Дъбница
spanchevci	Спанчевци
yakovitsa	Яковица
dubovets	Дъбовец
dubovik	Дъбовик
dubovi	Дъбови
dubovitsa	Дъбовица
dubovo	Дъбово
dubrava	Дъбрава
dubravata	Дубравата
surnec	Сърнец
dubravite	Дъбравите
dubravitsa	Дъбравица
dubravka	Дъбравка
dubrovnik	Дубровник
duganovo	Дуганово
dukhlevtsi	Духлевци
trapishte	Трапище
dukhovets	Духовец
dukhovo	Дъхово
dukovtsi	Дъковци
dulboki	Дълбоки
dulgach	Дългач
spasovtsi	Спасовци
dulgodeltsi	Дългоделци
dulgopol	Дългопол
dulovo	Дулово
tikrit	Тикрит
dunavci	Дунавци
dunavets	Дунавец
vurbjane	Върбяне
dundalk	Дъндок
zahle	Захла
dunedin	Дънидин
dunevo	Дунево
dunevtsi	Дуневци
dungovo	Дънгово
duni	Дюни
dunkerque	Дюнкерк
dupnitsa	Дупница
durankulak	Дуранкулак
durbolar	Дърболан
durcha	Дурча
durlevtsi	Дърлевци
durmanci	Дърманци
durmantsi	Дърманци
durovtsi	Дуровци
durres	Дуръс
durvari	Дървари
durvenitsa	Дървеница
durzhanitsa	Държаница
stevrek	Стеврек
durzhaven	Държавен
taraclia	Тараклия
vishlene	Вишлене
dushantsi	Душанци
dushevo	Душево
dushinkovo	Душинково
dushintsi	Душинци
stakevci	Стакевци
duskarite	Дъскарите
duskot	Дъскот
duskotna	Дъскотна
dusseldorf	Дюселдорф
trubach	Тръбач
duzhdino	Дъждино
duzhdovnica	Дъждовница
duzhdovnik	Дъждовник
yugovo	Югово
dvorishte	Дворище
dyadovo	Дядово
turne	Търне
vurlino	Върлино
tuchenica	Тученица
dyakovo	Дяково
dyaluk	Дялък
dyankovo	Дянково
dyugenite	Дюгените
zimevica	Зимевица
dyulgerska	Дюлгерска
dyulino	Дюлино
dyulitsa	Дюлица
dyulya	Дюля
dzhamuzovtsi	Джамузовци
dzhanka	Джанка
dzhebel	Джебел
dzhelepsko	Джелепско
dzherman	Джерман
dzherovo	Джерово
dzhigurovo	Джигурово
dzhilyaskovitsa	Джилясковица
dzhinchovtsi	Джинчовци
dzhinot	Джинот
vladimir	Владимир
dzhokari	Джокари
vrana	Врана
dzhulyunitsa	Джулюница
dzhumriite	Джумриите
dzhurkalitsa	Джуркалица
dzhurkovo	Джурково
dzhurovo	Джурово
zmeica	Змеица
dzivgeliya	Дзивгекия
edessa	Воден
trunitsa	Тръница
ulan-ude	Улан Уде
edinakovtsi	Единаковци
edinburgh	Единбург
edirne	Одрин
ednovertsi	Едноверци
edolo	Едоло
edrevo	Едрево
efrem	Ефрем
efreytor-bakalovo	Ефрейтор-Бакалово
eger	Егер
egrek	Егрек
egulnitsa	Егълница
eilat	Ейлат
vladaya	Владая
ekzarkh-antimovo	Екзарх-Антимово
elazig	Елязъг
stratford-upon-avon	Стратфорд на Ейвън
elechanova	Елечанова
elena	Елена
elenino	Еленино
elenite	Елените
tokelau	Токелау
zurich	Цюрих
elentsite	Еленците
eleshnica	Елешница
eleshnitsa	Елешница
yarebitsa	Яребица
yundola	Юндола
zhelyazkovtsi	Желявковци
elkhovec	Елховец
elkhovets	елховец
elkhovo	Елхово
elovdol	Еловдол
elovitsa	Еловица
el'ovo	Ельово
stanjanci	Станянци
vizitsa	Вижица
tsaritsa	Царица
emden	Емден
emen	Емен
emirovo	Емирово
telerig	Телериг
empoli	Емполи
enchec	Енчец
uzunite	Узуните
enchovtsi	Енчовци
enevo	Енево
sopotot	Сопотот
enina	Енина
enitsa	Еница
zingievtsi	Зингиевци
zhultika	Жълтика
vrattsa	Враца
en'ovets	Еньовец
entebbe	Ентебе
valparaiso	Валпараисо
erbil	Арбил
erden	Ерден
eremiya	Еремия
erevish	Еревиш
erfurt	Ерфурт
erlangen	Ерланген
erovete	Еровете
tenevo	Тенево
ese	Есе
esenica	Есеница
esenishte	Есенище
esenitsa	Есеница
esen	Есен
espoo	Еспоо
essen	Есен
esslingen	Еслинген
este	Есте
estepona	Естепона
estoril	Ещорил
eter	Етъра
etoumbi	Етумби
etropole	Етрополе
stoletovo	Столетово
evrenozovo	Евренозово
ezdimirtsi	Ездимирци
struindol	Струиндол
ezerets	Езерец
ezero	Езеро
veselets	Веселец
ezerovo	Езерово
vevey	Вьове
trakiets	Тракиец
tsenovich	Ценович
fakiya	Факия
falkovets	Фалковец
fatovo	Фатово
fazanovo	Фазаново
zhelyava	Желява
fes	Фес
strandzha	Странджа
filaretovo	Филаретово
filipovo	Филипово
tegucigalpa	Тегусигалпа
florentin	Флорентин
florina	Лерин
stob	Стоб
forli	Форли
formosa	Формоса
fotinovo	Фотиново
franceville	Франсвил
frauenfeld	Фрауенфелд
freiburg	Фрайбург
freising	Фрайзинг
yabulkovo	Ябълково
fresno	Фресно
frolosh	Фролош
fuenlabrada	Фуенлабрада
funchal	Фуншал
furen	Фурен
furevtsi	Фъревци
trakiytsi	Тракийци
tokyo	Токио
furore	Фуроре
furtuni	Фъртуни
gabare	Габаре
gabarevo	Габарево
gaberevo	Габерево
gaber	Габер
gaberovo	Габерево
gabraka	Габрака
gabra	Габра
zhinzifovo	Жинзифово
gabreshevtsi	Габрешевци
gabrica	Габрица
gabrina	Габрина
gabritsa	Габрица
gabrovdol	Габровдол
gabrovica	Габровица
gabrovitsa	Габровица
gabrovnica	Габровница
gabrovnitsa	Габровница
gabrovo	Габрово
gabrovtsi	Габровци
gabur	Габър
gaburnitsa	Габърница
gaburska	Габърска
gachovtsi	Гачовци
gagalya	Гагаля
gaganica	Гаганица
gaganitsa	Гаганица
gagovo	Гагово
gagra	Гагра
veselec	Веселец
galati	Галац
sovata	Совата
galiche	Галиче
galishhe	Галище
galishte	Галище
sukhino	Сухино
galway	Голуей
gambia	Гамбия
ganchovets	Ганчовец
ganchovo	Ганчово
zvezda	Звезда
tinkovo	Тинково
garvan	Гарван
zhelyazkovets	Желясковец
gashtevtsi	Гащевци
vurzulitsa	Вързулица
gavrailovo	Гавраилово
gaydari	Гайдари
gaykinite	Гайкините
gaytanevo	Гайтанево
gaytaninovo	Гайтаниново
vishovgrad	Вишовград
visok	Висок
gaza	Газа
gazurnitsite	Газурниците
gdansk	Гданск
gdynia	Гдиня
gecovo	Гецово
gega	Гега
gegovi	Гегови
gela	Гела
gelemenovo	Гелеманово
genchovtsi	Генчовци
vadstena	Вадстена
general-fichevo	Генерал-Фичево
general-geshevo	Генерал-Гешево
svetovrachene	Световрачене
general-kantardzhievo	Генерал-Кантарджиево
general-kiselovo	Генерал-Киселово
sokolnik	Соколник
general-marinovo	Генерал-Мариново
todorichene	Тодоричене
vlasatica	Власатица
general-toshevo	Генерал-Тошево
geneve	Женева
genova	Генуа
genovo	Геново
genovtsi	Геновци
gent	Гент
genya	Геня
georgia	Грузия
georgi-damyanovo	Георги-Дамяново
georgi-dobrevo	Георги-Добрево
zementsi	Земенци
geranovitsa	Герановица
geranya	Гераня
gergevec	Гергевец
gergevets	Гергевец
gergichka	Гергичка
gergini	Гергини
zvunarci	Звънарци
vallejo	Валехо
gesha	Геша
turnovlak	Търновлак
yakhinovo	Якиново
getsovo	Гетцово
gibraltar	Гибралтар
gigen	Гиген
gigintsi	Гигинци
ginci	Гинци
gintsi	Гинци
srednya	Средня
girchevtsi	Гирчевци
gita	Гита
vulchedrum	Вълчедръм
gjirokaster	Аргирокастро
gjueshevo	Гюешево
gjul'ovca	Гюльовца
gjurgich	Гюргич
glasgow	Глазгоу
glashatay	Глашатай
zambezi	Замбези
glava	Глава
glavanci	Главанци
sugarevo	Сугарево
glavanovtsi	Главановци
glavantsi	Главанци
glavatar	Главатар
glavatartsi	Главатарци
glavatsi	Главаци
glavinica	Главиница
glavinitsa	Главиница
gledachevo	Гледачево
uzundzhata	Узунджата
stolt	Столът
glendale	Глендейл
yagnevo	Ягнево
gloginka	Глогинка
vrachesh	Врачеш
glogovets	Глоговец
glogovitsa	Глоговица
tumbalovo	Тумбалово
voynitsi	Войници
glozhene	Гложене
glufishevo	Глуфичево
glukhar	Глухар
glumche	Глумче
glumovo	Глумово
glushka	Глушка
glushnik	Глушник
glutnitsite	Глутниците
gnezdare	Гнездаре
gnilyane	Гниляне
gnyazdovo	Гняздово
godech	Годеч
godeshevo	Годешево
godlevo	Годлево
vidbol	Видбол
golak	Голак
topilishta	Топлища
tangier	Танжер
vukan	Вукан
golec	Голец
golemanci	Големанци
golemani	Големани
golemanite	Големаните
tutrakantsi	Тутраканци
golemantsi	Големанци
golemin	Големин
golesh	Голеш
goleshovo	Голешово
goleta	Голита
golets	Голец
golica	Голица
yurukovo	Юруково
golitsa	Голица
goljanovci	Голяновци
golobrad	Голобрад
golobradovo	Голобрадово
gol'ovitsa	Гольовица
golyanovtsi	Голяновци
zaevete	Заевете
gomotartsi	Гомотарци
uchkuntsi	Ушкунци
ta'if	Таиф
strakhil	Страхил
gorchevo	Горчево
goreme	Гореме
gorica	Горица
gorichane	Горичане
gorichevo	Горичево
goritsa	Горица
gornenite	Горненинте
gornik	Горник
gornoseltsi	Горноселци
gornoslav	Горнослав
gornyani	Горняни
gorobiovtsi	Горобиовци
gorochevtsi	Горочевци
gorocvet	Гороцвет
gorostanete	Горощанете
gorotsvet	Горовец
gorovo	Горово
gorska	Горска
gorsko	Горско
gortalovo	Горталово
gorublyane	Горубляне
gorunaka	Горунака
gorun	Горун
surtsevo	Сърцето
goryani	Горяни
topoljane	Тополяне
gospodinovo	Господиново
gospodintsi	Господинци
gostilica	Гостилица
gostilitsa	Гостилица
gostilja	Гостиля
gostilya	Гостиля
gostina	Гостина
gostivar	Гостивар
gostun	Гостун
gottingen	Гьотинген
vodentsi	Воденци
govedarci	Говедарци
govedare	Говедаре
govedartsi	Говедарци
govezhda	Говежда
g'ovren	Гьоврен
gozdevitsa	Гоздевица
gozdeyka	Гоздейка
goz	Гоздейка
goznitsa	Гозница
verigovo	Веригово
gradeshnica	Градешница
gradeshnitsa	Градешница
gradets	Градец
gradevo	Градево
gradezhnica	Градежница
gradezhnitsa	Градешница
gradina	Градина
gradinarovo	Градинарово
gradini	Градини
gradinka	Градинка
gradishhe	Градище
gradishte	Градище
gradnica	Градница
gradnitsa	Градница
gradoman	Градоман
gradsko	Градско
zavala	Завала
gradut	Градът
graenna	Грена
grafitovo	Графитово
gramada	Грамада
gramadata	Грамадата
gramade	Грамаде
gramadlivo	Грамадливо
gramatikovo	Граматиково
gramatitsi	Граматици
gramazhdano	Грамаждано
granada	Гранада
granica	Граница
ustren	Устрен
stoynovo	Стойново
granitets	Гранитец
granit	Гранит
granitovo	Гранитово
granitsa	Граница
grashevo	Грашево
grashtitsa	Гращица
grasse	Грас
graz	Грац
greenland	Гренландия
greenock	Грийнок
greevtsi	Греевци
grenada	Гренада
tsruncha	Црънча
stomanevo	Стоманево
grivica	Гривица
grivitsa	Гривица
grivjak	Гривяк
grivka	Гривка
grivyak	Гривяк
grokhotno	Грохотно
gromshin	Громшин
verinsko	Веринско
grozd'ovo	Гроздьово
tuden	Туден
grublevtsi	Гръблевци
gruevo	Груево
gruncharovo	Грънчарово
gruncherite	Грънчерите
zelendol	Зелендол
grytviken	Грютвикен
guadeloupe	Гваделупа
guam	Гуам
vinevo	Винево
gubesh	Губеш
gubislav	Губислав
gudevitsa	Гудевица
gugutka	Гугутка
gulija	Гулия
gulijka	Гулийка
guliya	Гулия
guliyka	Гулийка
gulubari	Гълъбари
gulubec	Гълъбец
gulubets	Гълъбец
zvunartsi	Звънарци
gulubinka	Гълъбинка
gulubintsi	Гълъбинци
gulubnik	Гълъбник
studenica	Студеница
gulubovtsi	Гълъбовци
yagodovo	Ягодово
gumoshtnik	Гумощник
gumzovo	Гъмзово
gurbanovtsi	Гърбановци
gurbino	Гърбино
gurbishhe	Гърбище
gurbishte	Гърбище
gurchinovo	Гърчиново
gurdevtsi	Гърдевци
gurdezh	Гърдеж
gurgulitsa	Гургулица
gurgulyat	Гургулят
gurkovo	Гурково
vulchandol	Вълчандол
gurlyano	Гърляно
gurmazovo	Гурмазово
volovarci	Воловарци
strumyani	Струмяни
velikhodzhalar	Велиходжалар
gurnya	Гърня
guskovo	Гъсково
gusla	Гусла
guslar	Гуслар
gutsal	Гуцал
guyane	Френска Гвиана
treklyano	Тркляно
zagoriche	Загориче
gyudyurska	Гюдюрска
gyueshevo	Гюшево
gyul'ovtsa	Гюльовца
gyumri	Гюмри
gyurgevo	Гюргево
gyurgich	Гюргич
haarlem	Хаарлем
hafnarfjordur	Хапнарфьордюр
haifa	Хайфа
halle	Хале
hamburg	Хамбург
hamilton	Хамилтън
hannover	Хановер
harbin	Харбин
harrisburg	Харисбърг
hasanbejli	Блъсково
hastings	Хейстингс
hatvan	Хатван
havana	Хавана
yagoda	Ягода
hayward	Хейуърд
heerlen	Хеерлен
heidelberg	Хайделберг
helmstedt	Хелмщет
helsinki	Хелзинки
herat	Херат
hiroshima-shi	Хирошима
hirsova	Хърсово
hollywood	Холивуд
holon	Холон
homyel'	Гомел
vurbovo	Върбово
honolulu	Хонолулу
houston	Хюстън
vojnjagovo	Войнягово
hue	Хюе
husum	Хузум
tulsa	Тълса
ichera	Ичера
idfu	Едфу
idilevo	Идилево
iganovo	Иганово
iglika	Иглика
ignatica	Игнатица
ignatievo	Игнатиево
ignatitsa	Игнатица
ignatovo	Игнатово
ignatovtsi	Игнатовци
igoumenitsa	Игуменица
igralishhe	Игралище
igralishte	Игралище
ikhtiman	Ихтиман
vidima	Видима
ilievtsi	Илиевци
ilijno	Илийно
ilindenci	Илинденци
ilinden	Илинден
ilindentsi	Илинденци
ilinitsa	Илиница
ilitsa	Илица
iliya-bluskovo	Илия-Блъсково
iliya	Илия
iliyantsi	Илиянци
suchka	Съчка
iliysko	Илийско
iliyuvtsi	Илювци
il'ovskoto	Ильовското
zlatitrap	Златитрап
imrenchevo	Имренчево
ingolstadt	Инголщат
innsbruck	Инсбрук
sredok	Средок
inverness	Инвърнес
ioannina	Янина
zaraevo	Зараево
ipswich	Ипсуич
iquique	Икике
varchovtsi	Варчовци
irechek	Иречек
stikul	Стикъл
vedrovo	Ведрово
irinetsi	Иринеци
spanchevtsi	Спанчевци
irvine	Ървайн
iskra	Искра
vurbentsi	Върбенци
iskrets	Искрец
iskrica	Искрица
iskril	Искри
iskritsa	Искрица
iskur	Искър
stalevo	Сталево
isperikh	Исперих
isperikhovo	Исперихово
zhedilovo	Жедилово
ivajlo	Ивайло
ivancha	Иванча
travnik	Травник
ivanivanovtsi	Иванивановци
stranska	Странска
zet'ovo	Зетьово
ivanovo	Иваново
ivanovtsi	Ивановци
ivanshnitsa	Иваншница
ivanski	Ивански
ivantsi	Иванци
ivan-vazovo	Иван_Вазово
ivanyane	Иваняне
ivaylo	Ивайло
ivaylovgrad	Ивайловград
izbeglii	Избегли
izbul	Избул
zheljazno	Желязно
vidrare	Видраре
iztochnik	Источник
izvorche	Изворче
izvorishhe	Изворище
izvorishte	Изворище
izvor	Извор
izvornik	Изворник
teketo	Текето
izvorsko	Изворско
jablanovo	Ябланово
jabulchevo	Ябълчево
vuglarovo	Въгларово
jabulkovo	Ябълково
jackson	Джаксън
jacksonville	Джаксънвил
jagnilo	Ягнило
jagoda	Ягода
jagodina	Ягодина
jagodovo	Ягодово
jakarta	Джакарта
jakhinovo	Яхиново
yabulka	Ябълка
jamaica	Ямайка
jamna	Ямна
jana	Яна
jankovo	Янково
jantra	Янтра
japan	Япония
jardzhilovci	Ярджиловци
jarebica	Яребица
jarlovo	Ярлово
zimornitsa	Зиморница
tarsus	Тарс
jasenovec	Ясеновец
jasenovo	Ясеново
jastreb	Ястреб
jastrebovo	Ястребово
javorec	Яворец
javornica	Яворница
syktyvkar	Сиктивкар
jbail	Библос
jeddah	Джидда
jekabpils	Йекабпилс
jericho	Йерихон
jerusalem	Йерусалим
jesi	Йези
jesolo	Йезоло
joensuu	Йоенсу
joglav	Йоглав
johannesburg	Йоханесбург
jonkovo	Йонково
jordanovo	Йорданово
jovkovo	Йовково
voyvodinovo	Войводиново
julievo	Юлиево
spatovo	Спатово
trudovec	Трудовец
juper	Юпер
vranya	Враня
kabile	Кабиле
thun	Тун
kableshkovo	Каблешково
kabul	Кабул
kacelovo	Кацелово
vetrishte	Ветрище
kadievo	Кадиево
kadikoey	Халкедон
troyan	Троян
vaskovo	Весково
kaernten	Каринтия
kaiserslautern	Кайзерслаутерн
vlakhi	Влахи
ustovo	Устово
kalaydzhievo	Калайджиево
trud	Труд
kalchevo	Калчево
kalchovska	Калчовска
kalchovtsi	Калчовци
kalejca	Калейца
kalekovec	Калековец
kalekovets	Калековец
kalenik	Каленик
kalen	Кален
kalenovtsi	Каленовци
kalevishte	Калевище
kaleytsa	Калейца
kalimanci	Калиманци
kalimanitsa	Калиманица
kalimantsi	Калиманци
verentsi	Веренци
kaliningrad	Калининград
kalinka	Калинка
kalino	Калино
tsarichino	Царичино
kalishhe	Калище
kalishte	Калище
kalitinovo	Калитиново
kalkas	Калкас
kalkovo	Калково
vladimirovtsi	Владимировци
kalnishte	Калнище
kalofer	Калофер
kalojanci	Калоянци
kalojan	Калоян
kalojanovec	Калояновец
kalojanovo	Калояново
kalomen	Каломен
kalotina	Калотина
kalotintsi	Калотинци
kalovo	Калово
stryama	Стряма
uruchovtsi	Уручевци
kaloyanovo	Калояново
kaloyantsi	Калоянци
kaltinets	Калтинец
zagorski	Загорски
kalugeritsa	Калугерица
kalugerovo	Калугерово
vurlinka	Върлинка
kamburovo	Камбурово
kamchiya	Камчия
varad	Варад
kamenari	Каменари
kamenar	Каменар
kamenartsi	Каменарци
kamenchanska	Каменчанска
kamenec	Каменец
kamenets	Каменец
kamenik	Каменик
kamenitsa	Каменица
kamenjak	Каменяк
kamenka	Каменка
kamen	Камен
kamenna	Каменна
kameno	Камено
kamenovo	Каменово
kamensko	Каменско
zhelyazovo	Желязово
kamenyak	Каменяк
kamenyane	Каменяне
kameshtitsa	Каменица
kampala	Кампала
kanara	Канара
kandilka	Кандилка
kandovi	Кандови
kandzhiyska	Канджийска
kandzhulitsa	Канджулица
zaritsa	Зарица
kanjak	Каняк
kantari	Кантари
kanyak	Каняк
kaolinovo	Каолиново
kapatovo	Капатово
kapel	Капел
kapishte	Капище
zlatija	Златия
kapitan-dimitrievo	Капитан-Димитриево
kapitan-dimitrovo	Капитан-Димитрово
kapitanovci	Капитановци
kapitanovtsi	Капитановци
topolska	Тополска
karachi	Карачи
vurbino	Върбино
karadzhovo	Караджово
sredinka	Срединка
karageorgievo	Карагеоргиево
tervel	Тервел
karaivantsa	Караиваница
karaivantsi	Караиванци
karalite	Каралите
karamanci	Караманци
karamanite	Караманите
karamanitsa	Караманица
tijuana	Тихуана
karamantsi	Караманци
karamfil	Карамфил
karamichevska	Карамичевска
karanci	Каранци
karandili	Карандил
vikhren	Вихрен
karantsi	Каранци
karapelit	Карапелит
karapoltsi	Караполци
karash	Караш
karavelovo	Каравелово
karavel'ovo	Каравельово
karbala	Кербала
karbintsi	Карбинци
kardam	Кардам
kariyata	Карията
yavorets	Яворец
karlovo	Карлово
karlovsko	Карловско
karlsruhe	Карлсруе
visokovtsi	Високовци
ulm	Улм
karvuna	Карвуна
karyuvtsi	Карювци
kasaliyska	Касалийска
kasapsko	Касапско
kashentsi	Кашенци
kashi	Кашгар
kashina	Кашина
kasilag	Касилаг
kasnakovo	Каснаково
kaspichan	Каспичан
kassel	Касел
turnene	Търнене
strazhnitsa	Стражница
turokovtsi	Туроковци
katowice	Катовице
katrandzhii	Катранджии
katranitsa	Катраница
tabora	Табора
katrishte	Катрище
katselovo	Кацелово
topolchane	Тополчане
katunci	Катунци
katunec	Катунец
katunets	Катунец
katunica	Катуница
tabashka	Табашка
katunitsa	Катуница
katuntsi	Катунци
kavaje	Кавая
vankovtsi	Ванковци
kavlak	Кавлак
kavrakirovo	Кавракирово
kayaloba	Каялоба
kaykovska	Кайковска
kaynardzha	Кайнарджа
kayryaka	Кайряка
zhultesh	Жълтеш
kazak	Казак
kazanka	Казанка
kazanluk	Казанлък
kazashko	Казашко
kazatsi	Казаци
kazatsite	Казаците
yakoruda	Якоруда
kazimir	Казимир
srem	Срем
sracimir	Срацимир
kereka	Керека
kerenite	Керените
kermen	Кермен
kesarevo	Кесарево
kestenevo	Кестеново
tatul	Татул
kestenovo	Кестеново
khadzhidimitrovo	Хаджидимитрово
khadzhidimovo	Хаджидимово
khadzhievo	Хаджиево
zakhari-stoyanovo	Захари-Стояново
wimbledon	Уимбълдън
khalvadzhiysko	Халваджийско
khambar	Хамбар
khanovete	Хановете
khanovo	Ханово
kharacherite	Харачерите
kharkiv	Харков
zanoga	Занога
kharmanli	Харманли
terziyska	Терзийска
kharvalovtsi	Харваловци
khasakiite	Хасекиите
khaskovo	Хасково
starichene	Старичене
vratarite	Вратарите
khayredin	Хайредин
urvata	Урвата
khirevo	Хирево
khisar	Хисар
khisarya	Хисаря
khitovo	Хитово
khitrevtsi	Хитревци
khiwa	Хива
khlevene	Хлевене
khljabovo	Хлябово
khlyabovo	Хлябово
khodzhalar	Ходжалар
khodzhovtsi	Ходжовци
khotanca	Хотанца
khotantsa	Хотанца
khotnica	Хотница
khotnitsa	Хотница
stockholm	Стокхолм
svetoslav	Светослав
khrabrovo	Храброво
khrabursko	Храбърско
khrasna	Храсна
khrastovo	Храстово
khrishheni	Хрищени
khrishteni	Хрищени
khrisokefalos	Вълково
khristijanovo	Християново
khristiyanovo	Християново
khristo-danovo	Христо-Даново
khristovtsi	Христовци
khromitsa	Хромица
khrsovo	Хърсово
khubanovtsi	Хубановци
khubavene	Хубавене
khujand	Ходжент
vulchin	Вълчин
khuma	Хума
khunevtsi	Хъневци
khurlec	Хърлец
khurlets	Хърлец
khursovo	Хърсово
khvojna	Хвойна
khvostjane	Хвостяне
khvostyane	Хвостяне
khvoyna	Хвойна
khvurchil	Хвърчил
kichenica	Киченица
kichenitsa	Киченица
kichevo	Кичево
kichushka	Кичушка
kielce	Келце
terziyuvtsi	Терзийци
kiev	Киев
sredoseltsi	Средоселци
subotkovtsi	Съботковци
kikhayovtsi	Кихаьовци
kilifarevo	Килифарево
tadmur	Палмира
veren	Верен
vekilski	Векилски
vodenichane	Воденичане
kirchevo	Кирчево
kireevo	Киреево
kirevtsi	Киревци
kirilovo	Кирилово
kirklareli	Лозенград
vodata	Водата
kirovo	Кирово
kiselets	Киселец
kiselevo	Киселево
kiselichevo	Киселичево
kiselitsa	Киселица
kiselitsata	Киселицата
kiselkovtsi	Киселковци
kisiytsite	Кисийците
kis'ovtsi	Кисьовци
velikan	Великан
kitee	Китее
sturgel	Стъргел
yarlovo	Ярлово
kitka	Китка
kitna	Китна
kitnitsa	Китница
kjulevcha	Кюлевча
kladenchevo	Кладенчево
kladenets	Кладенец
kladentsi	Кладенци
kladnica	Кладница
kladnitsa	Кладница
kladorub	Кладоръб
startsevo	Старцево
klementina	Клементина
klenovik	Кленовик
klepalo	Клепало
uzovo	Узово
klikach	Кликач
klimash	Климаш
kliment	Климент
klimentovo	Климентово
klisura	Клисура
klisuritsa	Клисурица
yovkovtsi	Йовковци
klokotnica	Клокотница
klokotnitsa	Клокотница
klych	Ключ
klyuchevo	Ключево
vologda	Вологда
kmetovtsi	Кметовци
knezha	Кнежа
knezovo	Кнезово
knizhovnik	Книжовник
taganrog	Таганрог
staroseltsi	Староселци
knyazhevsko	Княжевско
kobilino	Кобилино
kobiljak	Кобиляк
yasenovo	Ясеново
subrano	Събрано
kobilyane	Кобиляне
koblenz	Кобленц
kochani	Кочани
kochan	Кочан
kocherinovo	Кочериново
vaklino	Ваклино
k'ochevtsi	Кочевци
kochmar	Кочмар
kochovo	Кочово
koeln	Кьолн
koevtsi	Коевци
koilovci	Коиловци
koilovtsi	Коиловци
kojnare	Койнаре
svatbare	Свадбаре
kokaljane	Кокаляне
verenci	Веренци
kokiche	Кокиче
kokkinia	Бърхово
kokora	Кокора
kokorkovo	Кокорково
trivoditsi	Триводици
kokoshane	Колошане
kolarci	Коларци
kolari	Колари
kolarovo	Коларово
zhizhevo	Жижево
kolec	Колец
kolena	Колена
kolets	Колец
kolibite	Колибите
kolich	Колич
zavet	Завет
sori	Сори
kolobur	Колобър
kolomna	Коломна
kolosh	Колош
kolusha	Колуша
kolushevo	Колючево
komarevo	Комарево
komatevo	Коматево
komodo	Комодо
ushintsi	Ушинци
komoshtitsa	Комощица
komotini	Гюмюрджина
komshtitsa	Комщица
komunari	Комунари
komuniga	Комунига
konak	Конак
konare	Конаре
voyvodino	Войводино
konarskoto	Конарското
konche	Конче
kondofrey	Кондофрей
kondolovo	Кондолово
strezimirovci	Стрецимировци
kondurite	Кондурите
konevec	Коневец
konevets	Коневец
konevod	Коневод
konevo	Конево
konjavo	Коняво
konnitsi	Конници
konop	Конор
kon'ovec	Коньовец
kon'ovitsa	Коньовица
kon'ovo	Коньово
zafirovo	Зафирово
konskowola	Консковола
konstantin	Константин
konstantinovets	Константиновец
konstantinovo	Константиново
kontil	Контил
tsruklevtsi	Цръклевци
konya	Кония
konyartsi	Конярци
konyavo	Коняво
sunnyvale	Сънивейл
kopadan	Копадан
kopanica	Копаница
kopanitsa	Копаница
yunatsi	Юнаци
svetlen	Светлен
kopcheliite	Копчелиите
suruvchevtsi	Сурувчевци
kopilovtsi	Копиловци
kopitnik	Копитник
koprec	Копрец
koprets	Копрец
koprinka	Копривка
zhilenci	Жиленци
koprivec	Копривец
koprivets	Копривец
koprivlen	Копривлен
koprivshtitsa	Копривщица
koren	Корен
koriite	Кориите
sokolsko	Соколско
koriten	Коритен
velino	Велино
korkina	Коркина
kormisosh	Кормисош
kormjansko	Кормянско
kormyansko	Кормянско
kornica	Корница
kornitsa	Корница
korova	Корова
korten	Кортен
kortrijk	Кортрейк
kosacha	Косача
kosara	Косара
voynyagovo	Войнягово
k'oseva	Кьосева
k'osevo	Кьосево
zidarovo	Зидарово
ticha	Тича
kosharevo	Кошарево
kosharica	Кошарица
kosharinska	Кошаринска
straubing	Страубинг
kosharitsa	Кошарица
kosharna	Кошарна
koshava	Кошава
koshnichari	Кошничари
koshnitsa	Кошница
koshov	Кошов
koshuta	Кошута
koshute	Кошуте
kosice	Кошице
kosilka	Косилка
kos	Кос
kosmata	Космата
zamfir	Замфир
kosovets	Косовец
kosovite	Косовите
kosovo	Косово
kostadinite	Костадините
kostandenec	Костанденец
kostandenets	Костанденец
kostandovo	Костандово
kostelevo	Костелево
kostel	Костел
kostenec	Костенец
kostenets	Костенец
kostenkovtsi	Костенковци
kosten	Костен
tsatsarovtsi	Цацаровци
tsurvishte	Цървище
kostievo	Костиево
zelenigrad	Зелениград
kostilkovo	Костиково
kostinbrod	Костинброд
kostino	Костино
kostovtsi	Костовци
kosturino	Костурино
kosturintsi	Костуринци
kostur	Костур
tekirdag	Родосто
kotenovtsi	Котеновци
kotlari	Котлари
kotlenci	Котленци
kotlentsi	Котленци
kotovtsite	Котовците
toshevtsi	Тошевци
koulamoutou	Куламуту
kovachevci	Ковачевци
vrabevo	Врабево
kovachevets	Ковачевец
kovachevitsa	Ковачевица
kovachevo	Ковачево
kovachevtsi	Ковачевци
kovachica	Ковачица
tikale	Тикале
strazhitsa	Стражица
sveshhari	Свещари
kovandzhiite	Кованджиите
kovil	Ковил
koychovtsi	Койчовци
koynare	Койнаре
sokolovo	Соколово
kozani	Кожани
kozanovo	Козаново
kozare	Козаре
kozarevec	Козаревец
kozarevets	Козаревец
kozarevo	Козарево
kozarka	Козарка
kozarsko	Козарско
kozhari	Кожари
kozhintsi	Кожинци
kozhlyuvtsi	Кожлювци
kozhukhartsi	Кожухарци
kozica	Козица
kozichino	Козичино
kozino	Козино
kozitsa	Козица
kozjak	Козяк
kozlec	Козлец
kozlets	Козлец
kozlevo	Козлево
kozlodujci	Козлодуйци
kozloduy	козлодуй
thessaloniki	Солун
kozlovec	Козловец
kozlovets	Козловец
koznitsa	Козница
kozyak	Козяк
trintchovitza	Трънчовица
venice	Венеция
tseretelevo	Церетелево
kragujevac	Крагуевац
kraishhe	Краище
yoakim-gruevo	Йоаким-Груево
krajgorci	Крайгорци
krajnici	Крайници
krakow	Краков
tvurditsa	Твърдица
kralevdol	Кралевдол
kralevo	Кралево
veliko	Велико
yalbotina	Ялботина
kranevo	Кранево
kran	Кран
kranovo	Краново
krantovtsi	Крантовци
krapchene	Крапчене
krapec	Крапец
krapets	Крапец
krasava	Красава
krasen	Красен
krasimir	Красимир
vurbovchets	Върбовчец
krasnogor	Красногор
krasnoselci	Красноселци
krasnoseltsi	Красноселци
krasnovo	Красново
kravino	Кравино
kravoder	Краводер
kraygortsi	Крайгорци
krayna	Крайна
kraynitsi	Крайнинци
kraynovo	Крайново
yana	Яна
krefeld	Крефелд
vetrushka	Ветрушка
kremene	Кремене
visegrad	Вишеград
trapoklovo	Трапоклово
kremenitsa	Кременица
kremen	Кремен
svetlya	Светля
turku	Турку
stremtsi	Стремци
struino	Струино
yanino	Янино
kresna	Кресна
kreta	Крета
kribul	Крибул
krichim	Кричим
krilatica	Крилатица
krilatitsa	Крилатица
krilyuvtsi	Крилювци
krin	Крин
krislovo	Крислово
kristiansand	Кристиансанд
krivenik	Кръвеник
krivica	Кривица
krivina	Кривина
krivini	Кривини
vrabtsite	Врабците
krivnja	Кривня
krivnya	Кривня
svezhen	Свежен
yabulchevo	Ябълчево
stojkite	Стойките
krojach	Крояч
kromidovo	Кромидово
kroyachevo	Кроячево
kroyach	Крояч
kroyatsi	Крояци
krukozhabene	Кръкожабене
krumchevtsi	Крумчевци
krum	Крум
vilnius	Вилнюс
krumovo	Крумово
kruncha	Крънча
krundzhilitsa	Крънджилица
krun	Крън
krupen	Крупен
krupnik	Крупник
krusevac	Крушевац
krushaka	Крушака
stremci	Стремци
krushare	Крушаре
krushari	Крушари
krushata	Крушата
krusheto	Крушето
starchevo	Старчево
krushevets	Крушевец
krushevo	Крушево
krushevska	Крушевска
vurbyane	Върбяне
krushno	Кръшно
krusholak	Крушолак
krushovene	Крушовене
krushovica	Крушовица
krushovitsa	Крушовица
krushovo	Крушово
krushuna	Крушуна
krustatitsa	Кръстатица
krustava	Кръстава
krustenyatsite	Кръстеняците
sredishhe	Средище
krustevich	Кръстевич
sredska	Средска
vitoria-gasteiz	Витория
krustina	Кръстина
kruvenik	Кръвеник
kryakovtsi	Кряковци
kubadin	Кубадин
kubas	Кубаш
kubrat	Кубрат
kubratovo	Кубратово
kucina	Куцина
kudelin	Куделин
kukes	Кукъс
kuklen	Куклен
kuklica	Къклица
kuklitsa	Къклица
kuklya	Кукля
vuzchukar	Въжчукар
kukovtsi	Куковци
kukurakhtsevo	Кукурахчето
yabulkovtsi	Ябълковци
kukuryak	Кукуряк
kukuvitsa	Кукувица
totleben	Тотлебен
kulata	Кулата
tlachene	Тлачене
stanford	Станфорд
kumanite	куманите
kumanovo	Куманово
kumanovtsi	Кумановци
kumaritsa	Кумарица
kumbaska	Кумбаска
kunchevo	Кънчево
kundevo	Кундево
tserovo	Церово
tampere	Тампере
kuopio	Куопио
kupen	Купен
kupinets	Къпинец
kupinovci	Къпиновци
viden	Виден
kupinovtsi	Къпиновци
kuptsite	Купците
kurchovsko	Кърчовско
kurdzhali	Кърджали
kurilo	Курило
kurlanovo	Кърланово
voluyak	Волуяк
kurnare	Кърнаре
kurnovo	Курново
windhoek	Виндхук
kurpachevo	Кърпачево
strelets	Стрелец
kurshalevo	Кършалево
kursk	Курск
kurtovo	Куртово
kurtozhabene	Къртожабене
kurulezite	курулезите
kusadasi	Кушадасъ
kusak	Късак
sredishte	Средище
kushla	Кушла
kushle	Къшле
todorcheta	Тодорчета
kushushlek	Кушушлек
svishtov	Свищов
kusovtsi	Късовци
suceava	Сучава
turnovci	Търновци
kutina	Кътина
suvorovo	Суворово
kutlovitsa	Кутловица
kutovo	Кутово
kutsarovtsi	Куцаровци
kutsina	Куцина
zhelyazno	Желязно
kutsovo	Кустово
zhelezna	Железна
kuz'ovo	Кузово
kyoto	Киото
kyulevcha	Кюлевча
kyustendil	Кюстендил
labets	Лабец
topolyane	Тополяне
lagerite	Лагерите
lagoshevtsi	Лагошевци
lagos	Лагос
vratitsa	Вратица
lakatnik	Лакатник
lale	Лале
lalkovo	Лалково
lambovtsi	Ламбовци
strizhba	Стрижба
lancaster	Ланкастър
lapadets	Лападец
lapavishkovtsi	Лапавишковци
larnaca	Ларнака
laskarevo	Ласкарево
laskar	Ласкар
sopovo	Сопово
lausanne	Лозана
lazar	Лазар
lazarovo	Лазарово
lazartsi	Лазарци
lebed	Лебед
tsonevska	Цоневска
lebnitsa	Лебница
lecce	Лече
lechevtsi	Лечевци
ledenik	Леденик
tvurdintsi	Твърдинци
vojvoda	Войвода
leipzig	Лайпциг
totyuvtsi	Тотювци
lekhovo	Лехово
lelintsi	Лелинци
lelystad	Лелистад
lenishhe	Ленище
lenishte	Ленище
lenkovo	Ленково
lenovo	Леново
lensko	Ленско
sokolyane	Соколяне
lepica	Лепица
lepitsa	Лепица
leshhak	Лещак
leshharka	Лещарка
veleshani	Велешани
leshko	Лешко
leshnica	Лешница
leshnikovo	Лешниково
leshnikovtsi	Лешниковци
leshnitsa	Лешница
staropatitsa	Старопатица
leshtarka	Лещарка
leshten	Лещен
lesicharka	Лесичарка
lesiche	Лесиче
szeged	Сегед
lesichevo	Лесичово
lesidren	Лесидрен
leska	Леска
leskovac	Лесковац
zajecar	zaychar
leskovets	Лесковец
leskovitsa	Лесковица
leskovo	Лесково
lesnovo	Лесново
ushuaia	Ушуая
lesura	Лесура
sudievo	Съдиево
letovnik	Летовник
leuven	Льовен
levka	Левка
teplen	Теплен
levski	Левски
levunovo	Левуново
leyarovo	Леярово
lhasa	Лхаса
liberec	Либерец
libreville	Либървил
libya	Либийска Арабска Джамахирия
liege	Лиеж
trajkovo	Трайково
lilekovo	Лилеково
liljache	Лиляче
liljak	Лиляк
liljanovo	Лиляново
lilkovo	Ликово
lille	Лил
lilyache	Лиляче
lilyach	Лиляч
lilyak	Лиляк
lilyanovo	Лиляново
trunchovica	Трънчовица
limassol	Лимасол
tauranga	Тауранга
limets	Лимец
limoges	Лимож
linz	Линц
lipen	Липен
lipets	Липец
lipintsi	Липинци
lipnica	Липница
lipnik	Липник
lipnitsa	Липница
lisbon	Лисабон
lisec	Лисец
lisets	Лисец
lisitsite	Лисиците
lisiya	Лисия
lisovo	Лисово
listec	Листец
listets	Листец
litakovo	Литаково
livada	Ливада
livadeto	Ливадето
livadkite	Ливадките
livermore	Ливърмор
liverpool	Ливърпул
livno	Ливно
livorno	Ливорно
zlatovrukh	Златовръх
vasilevo	Василево
ljaskovo	Лясково
swietochlowice	Швиентохловице
ljubcha	Любча
ljubenec	Любенец
ljuben	Любен
ljubenovo	Любеново
vitina	Витина
sukhozem	Сухозем
turnovets	Търновец
ljulin	Люлин
ljuljakovo	Люляково
ljutibrod	Лютиброд
zheravino	Жеравино
lobosh	Лобош
tsurkvitsa	Църквица
lodi	Лоди
lodz	Лодз
logodash	Логодаш
logodazh	Логодаж
vladislavtsi	Владиславци
lokorsko	Локорско
vozartsi	Вожарци
lomati	Ломът
sosnowiec	Сосновец
lomec	Ломец
vlore	Вльора
lom	Лом
lomnica	Ломница
lomnitsa	Ломница
lomtsi	Ломци
zlatoustovo	Златоустово
lopjan	Лопян
srednevo	Среднево
trstenik	Тръстеник
stroyno	Стойно
lopyan	Лопян
louisville	Луивил
lovchanci	Ловчанци
vurlina	Върлина
lovci	Ловци
lovech	Ловеч
turkhovo	Търхово
tintjava	Тинтява
lovnidol	Ловнидол
lovsko	Ловско
lovtsi	Ловци
lovtsite	Ловците
loza	Лоза
lozarevo	Лозарево
lozenec	Лозенец
lozenets	Лозенец
yalovo	Ялово
lozengradtsi	Лозенградци
lozenitsa	Лозеница
zgurovo	Згурово
lozeto	Лозето
velikovo	Великово
lozheto	Лозето
lozica	Лозица
lozitsa	Лозица
loznitsa	Лозница
lozno	Лозно
lublin	Люблин
lucca	Лука
ludogorci	Лудогорци
vurba	Върба
ludvika	Лудвика
zvunika	Звъника
ludzhene	Лъджене
luga	Лъга
luka	Лъка
lukata	Лъката
lukavitsa	Лъкавица
luki	Лъки
lukovit	Луковит
lukovitsa	Луковица
sredkovec	Средковец
luleburgaz	Люлебургаз
lulichka	Луличка
lulitsa	Лулица
lumava	Лъмава
topchijsko	Топчийско
lusaka	Лусака
luvino	Лъвино
luvovo	Лъвово
luvska	Лъвска
tjanevo	Тянево
luzhnica	Лъжница
luzhnitsa	Лъжница
l'viv	Лвов
lyakhovo	Ляхово
lyalintsi	Лялинци
lyaskovets	Лясковец
lyaskovo	Лясково
umnitsite	Умниците
lyon	Лион
lyubcha	Любча
tavalichevo	Таваличево
varana	Варана
lyubenovo	Любеново
lyubentsi	Любенци
lyubichevo	Любичево
lyubimets	Любимец
lyubino	Любино
terziite	Терзиите
lyublen	Любен
lyubnitsa	Любница
lyubovishte	Любовище
stublitsa	Стублица
yazdirastovtsi	Яждрасовци
lyulin	Люлин
lyulka	Люлка
lyulyak	Люляк
zlidol	Злидол
lyutadzhik	Лютаджик
lyutatsi	Лютаци
lyuteglav	Лютеглав
lyutibrod	Лютиброд
lyutidol	Лютидол
stefanovo	Стефаново
machkovtsi	Мачковци
macon	Макон
madan	Мадан
madara	Мадара
madison	Медисън
madrid	Мадрид
madzhare	Маджаре
surnino	Сърнино
madzharovo	Маджарово
madzherito	Маджерито
magardzhitsa	Магарджица
magdeburg	Магдебург
magerovi	Магерови
mahilyow	Могилев
mainz	Майнц
maiori	Майори
majsko	Майско
makak	Макак
zagorci	Загорци
makedonci	Македонци
makedonka	Македонка
makedontsi	Македонци
makhalata	Махалата
makhalnitsi	Махалници
vulchek	Вълчек
makhmutovtsi	Махмутовци
yamborano	Ямборано
makokou	Макоку
makotsevo	Макоцево
makovo	Маково
makresh	Макреш
sokolovtsi	Соколовци
malashevtsi	Малашевци
tompsun	Томпсън
malchika	Малчика
malchovtsi	Малчовци
malenovo	Маленово
malevo	Малево
malina	Малина
volovo	Волово
malino	Малино
malinovo	Малиново
stanintsi	Станинци
zhedna	Жедна
malmoe	Малмьо
malogradets	Малоградец
malomir	Маломир
malomirovo	Маломирово
malorad	Малорад
zornitsa	Зорница
malusha	Малуша
mamarchevo	Мамарчево
managua	Манагуа
zheglitsa	Жеглица
vurbnitsa	Върбница
manastirishhe	Манастирище
manastirishte	Манастирище
manastiritsa	Манастирица
staropatica	Старопатица
manastirsko	Манастирско
manastirtsi	Манастирци
zhitarnik	Житарник
tyurkmen	Тюркмен
mandra	Мандра
mandritsa	Мандрица
vranyak	Враняк
manila	Манила
manisa	Маниса
manizales	Манисалес
mannheim	Манхайм
manole	Маноле
manolich	Манолич
manolovo	Манолово
manoya	Маноя
manushevtsi	Манушевци
maqellare	Макеларе
maracaibo	Маракаибо
marafeltsi	Марафелци
maranello	Маранело
marash	Мараш
vardim	Вардим
marchevo	Марчево
marchino	Марчинао
margovtsi	Марговци
maribor	Марибор
trondheim	Трондхайм
mariefred	Мариефред
marikostinovo	Марикостиново
marinito	Маринито
marinka	Маринка
marino	Марино
marinovtsi	Мариновци
marishnitsa	Маришница
maritsa	Марица
mariyno	Марийно
markovo	Марково
taiwan	Тайван
stanec	Станец
marseille	Марсилия
marten	Мартен
martinique	Мартиника
martino	Мартино
martinovo	Мартиново
martinska	Мартинска
marulevo	Марулево
marutsekovtsi	Маруцековци
maryan	Марян
maryland	Мериленд
trustika	Тръстика
maslarevo	Масларево
maslinovo	Маслиново
maslovo	Маслово
mateshovtsi	Матешовци
matochina	Маточина
matovtsi	Матовци
matsa	Маца
mavrokhorion	Тисово
mayotte	Мейот
maysko	Майско
maystorovo	Майсторово
maytanyatsi	Майтаняци
suevo	Съево
mazyr	Мозир
mbabane	Мбабане
mecca	Мека
mechka	Мечка
mechkarevo	Мечкарево
mechkovitsa	Мечковица
zhrebichko	Жребичко
mechkovtsi	Мечковци
mechkul	Мечкул
mechovo	Мечово
mechovtsi	Мечовци
medan	Медан
medellin	Меделин
medeshevtsi	Медешевци
medevci	Медевци
medevtsi	Медевци
medina	Медина
medkovets	Медковец
mednikarovo	Медникарово
medovec	Медовец
medovene	Медовене
medovets	Медовец
medovina	Медовина
medovnitsa	Медовница
medovo	Медово
medven	Медвен
meknes	Мекнес
melbourne	Мелбърн
zagreb	Загреб
melnica	Мелница
melnik	Мелник
melnitsa	Мелница
melyane	Меляне
memphis	Мемфис
mendovo	Мендово
menenk'ovo	Мененково
menfi	Менфи
mengishevo	Менгишево
tsenino	Ценино
merdanya	Мерданя
merichleri	Меричлери
merilkovtsi	Мерилковци
merton	Камден
zupanja	Жупаня
meshhica	Мещица
svilengrad	Свиленград
messina	Месина
mesta	Места
metkovets	Метковец
zlataritsa	Златарица
metlichka	Метличка
metlika	Метлика
metodievo	Методиево
metokhiya	Метохия
metz	Мец
mexico	Мексико
meykovo	Мейково
mezdra	Мездра
mezdreja	Мездрея
sotirya	Сотирия
mezek	Мезек
zhernov	Жернов
valencia	Валенсия
mezhden	Межден
yaroslavtsi	Ярославци
michkovtsi	Мишковци
middlesbrough	Мидълсбро
mikhajlovo	Михайлово
mikhalaki-georgievo	Михалаки-Георгиево
mikhalchetata	Михалчетата
mikhalci	Михалци
stavertsi	Ставерци
zhelez	Желез
mikhaltsi	Михалци
mikhaylovo	Михайлово
mikhaylovtsi	Михайловци
mikhiltsi	Михилист
voynika	Войника
viskyar	Вискяр
mikre	Микре
mikrevo	Микрево
teshel	Тешел
mikromilea	Устица
stambolovo	Стамболово
miladinovo	Миладиново
ugurchin	Угърчин
zheravitsa	Жеравица
milanovo	Миланово
mile	Миле
milencha	Миленча
miletich	Милетич
milevo	Милево
milevtsi	Милевци
milino	Милино
milkovica	Милковица
milkovitsa	Милковица
milkovo	Милково
tonchevtsi	Тончевци
milkovtsi	Милковци
miloslavtsi	Милославци
milpitas	Милпитас
milwaukee	Милуоки
zagorichane	Загоричане
mindya	Миндя
minevtsi	Миневци
minkovo	Минково
minneapolis	Минеаполис
minori	Минори
minsk	Минск
zhergovets	Жерговец
mirchovtsi	Мирчовци
miriovets	Мириовец
mirjanci	Мирянци
zimnitsa	Зимница
mirolyubovo	Миролюбови
miromir	Миромир
mirovci	Мировци
topolitsa	Тополица
zvezdel	Звездел
mirovo	Мирово
vransko	Вранско
mirovyane	Мировяне
miryantsi	Мирянци
mishevsko	Мишевско
mishkarete	Мишкарете
mishkovtsi	Мишковци
miskolc	Мишколц
mitino	Митино
mitovska	Митовска
mitrovtsi	Митровци
miykovtsi	Мийковци
miziya	Мизия
mladen	Младен
mladenovtsi	Младеновци
vurbeshnica	Върбешница
topola	Топола
zagrade	Заграде
mlamolovo	Мламолово
mlechanovtsi	Млечановци
stremovo	Стремово
mlechino	Млечино
mlekarevo	Млекарево
zheglartsi	Жегларци
modesto	Модесто
modren	Модрен
moena	Моена
mogadishu	Могадишу
mogila	Могила
mogilata	Могилата
mogilec	Могилец
mogilets	Могилец
mogilica	Могилица
mogilino	Могилино
mogilishte	Могилище
mogilite	Могилите
yarlovitsa	Ярловица
mogilovo	Могилово
mogilyane	Могиляне
mohacs	Мохач
trojanovo	Трояново
mokresh	Мокреш
mokrishhe	Мокрище
mokrishte	Мокрище
molsheim	Молсхайм
mombasa	Момбаса
momchevo	Момчево
momchilgrad	Момчилград
momchilovci	Момчиловци
momchilovo	Момчилово
momchilovtsi	Момчиловци
momino	Момино
zdravets	Здравец
momkovo	Момково
monastir	Монастир
mondovi	Мондови
monevtsi	Моневци
mongolia	Монголия
mons	Монс
montana	Монтана
monterey	Монтерей
monteria	Монтерия
montevideo	Монтевидео
zhilino	Жилино
montreal	Монреал
montreux	Монтрьо
montserrat	Монсерат
morava	Морава
moravica	Моравица
moravitsa	Моравица
moravka	Моравка
moravska	Моравска
troyanovo	Трояново
morjanci	Морянци
surtse	Сърце
morozovo	Морозово
morsko	Морско
mortagonovo	Мортагоново
vasilovtsi	Василковци
moscow	Москва
moshino	Мошино
moshtanets	Мощанец
moskovec	Московец
voghera	Вогера
trebishte	Требище
mostar	Мостар
mostich	Мостич
mostino	Мостино
zelenik	Зеленик
mostovo	Мостово
mosul	Мосул
vodno	Водно
mrachenik	Мраченик
mraketintsi	Мракетинци
strumsko	Струмско
studena	Студена
mramor	Марамор
surpovo	Сърпово
mrezhichko	Мрежичко
mruzetsi	Мръзеци
mszczonow	Мшчонов
mudrec	Мъдрец
mudren	Мъдрен
mudrets	Мъдрец
mudrevo	Мъдрево
veselchane	Веселчане
mudritsa	Мъдрица
muenchen	Мюнхен
tseretsel	Церецел
muglene	Мъглене
muglen	Мъглен
muglishha	Мъглища
muglishta	Мъглища
tsurkva	Църква
mukhovo	Мъхово
muldava	Мулдава
mulhouse	Мюлуз
mumbai	Бомбай
muradiye	Мандър
murchaevo	Мърчаево
murchevo	Мърчево
mureno	Мурено
stradalovo	Страдалово
murgash	Мургаш
varvara	Варвара
murmansk	Мурманск
vladislav	Владислав
strumtsi	Стръмци
murtvinata	Мъртвината
murvodol	Мърводол
murzenite	Мързените
zenica	Зеница
musachevo	Мусачево
muselievo	Муселиево
strazha	Стража
musina	Мусина
musomishha	Мусомища
musomishta	Мусомища
solari	Солари
musurlii	Мъсърлии
vurtop	Въртоп
mutenitsa	Мътеница
mutnitsa	Мътница
mutsya	Муця
muzga	Мъзга
muzhentsi	Мъженци
myadna	Мядна
nachevo	Начево
uglen	Юглен
nadartsi	Надарци
nadezhda	Надежда
starilkovtsi	Старилковци
sturnica	Стърница
vurzilkovtsi	Вързулковци
nairobi	Найроби
vekhtovo	Вехтово
nancy	Нанси
nane	Нане
nanevo	Нанево
nanovica	Нановица
nanovitsa	Нановица
tsurkvishte	Църквище
nantes	Нант
volos	Волос
napa	Напа
zavoya	Завоя
narechen	Наречен
narvik	Нарвик
nasalevtsi	Насалевци
nashville	Нашвил
turnovka	Търновка
vurshilo	Вършило
srednogorska	Средногорска
nauchene	Научене
naum	Наум
teglio	Тельо
navusen	Навъсен
nayden-gerovo	Найден-Герово
naydenovo	Найденово
tomsk	Томск
zaychina	Зайчина
neapolis	Ляпчища
nebeska	Небеска
nedan	Недан
nedelevo	Неделево
nedelino	Неделино
strashimirovo	Страшимирово
nedelkovo	Неделково
nedevtsi	Недевци
nedjalsko	Недялско
nedkovtsi	Недковци
nedoklan	Недоклан
nedyalkovtsi	Недялковци
surnitsa	Сърница
vidanovo	Виданово
negentsite	Негенците
vurkhari	Върхари
negovanovci	Неговановци
negovanovtsi	Неговановци
toulon	Тулон
trunito	Трънито
nejkovo	Нейково
nenkovo	Ненково
nenovo	Неново
nenovtsi	Неновци
surnentsi	Сърненци
zaychari	Зайчари
neshevtsi	Нешевци
nesla	Несла
neuilly-sur-seine	Ньой сюр Сен
stomanci	Стоманци
nevestino	Невестино
turnicheni	Търничени
nevski	Невски
newark	Нюарк
turnovtsa	Търновца
vrata	Врата
neykovo	Нейково
neykovtsi	Нейковци
neynovtsi	Нейновци
neyshabur	Нишапур
vodnjanci	Воднянци
nice	Ница
nichovtsi	Нишовци
stoychovtsi	Стойчовци
nidobrsha	Добърско
niederoesterreich	Долна Австрия
stolnik	Столник
tsegrilovtsi	Цегриловци
nikjup	Никюп
nikoevtsi	Никоевци
nikolaevka	Николаевка
nikolaevo	Николаево
nikola-kozlevo	Никола-Козлево
nikolchovtsi	Николчовци
vinogradets	Виноградец
nikolichevtsi	Николичевци
nikolniki	Николники
vulkan	Вълкан
zvezdets	Звездец
nikopol	Никопол
nikudin	Никудин
nikyup	Никюп
nimes	Ним
nis	Ниш
tashkent	Ташкент
nitra	Нитра
niue	Ниуе
nivishta	нивища
tuzha	Тъжа
nivyanin	Нивянин
nochevo	Ночево
noevci	Ноевци
noevtsi	Ноевци
northampton	Нортхемптън
noseite	Носеите
sukhache	Сухаче
nouvelle-caledonie	Нова Каледония
novachene	Новачене
novachevo	Новачево
novachkini	Новачкини
novak	Новак
zvunche	Звънче
novakovtsi	Новаковци
novgrad	Новград
novogortsi	Новогорци
novoselci	Новоселци
novoselec	Новоселец
novoselets	Новоселец
novoselishhe	Новоселище
villeneuve-d'ascq	Вилньов д'Аск
novosel	Новосел
valledupar	Валедупар
tseperanite	Цепенарите
subkovtsi	Събковци
nozharevo	Ножарево
nozharovo	Ножарово
nozherite	Ножерите
nukus	Нукус
zhivovtsi	Животци
nuuk	Нуук
nyushkovtsi	Нушковци
oakland	Окланд
yudelnik	Юделник
obedinenie	Обединение
obel	Обел
obelya	Обеля
vitanovci	Витановци
obidim	Обидим
obitel	Обител
obninsk	Обнинск
obnova	Обнова
oborishhe	Оборище
sushina	Сушина
obradovtsi	Обрадовци
obretenik	Обретеник
obretkovtsi	Обретковци
obrochishhe	Оброчище
obrochishte	Оброчище
obruchishhe	Обручище
vlasovtsi	Власовци
obzor	Обзор
ochindol	Учиндол
ochusha	Очуша
ocmanlar	Османлар
odense	Одензе
odessa	Одеса
odorovtsi	odorovsi-
odranitsa	Одраница
odrinci	Одринци
odrintsi	Одринци
odrne	Одърне
odurci	Одърци
odurne	Одърне
odurtsi	Одърци
ogled	Оглед
ognen	Огнен
ognjanovo	Огняново
ognyanovo	Огняново
ogoya	Огоя
ogradishte	Оградище
ogradna	Оградна
ograzhden	Огражден
ohrid	Охрид
okhlyuvets	Охлювец
wetzlar	Вецлар
okhrid	Охрид
okoliite	Околиите
okop	Окоп
okorsh	Окорш
zheleznik	Железник
olomouc	Оломоуц
omaha	Омаха
oman	Оман
omarchevo	Омарчево
sushevo	Сушево
tsani-ginchevo	Цани-Гинчево
virove	Вирове
omurtag	Омуртаг
onogur	Оногур
opaka	Опака
opalovo	Опалово
vodolej	Водолей
opanets	Опанец
opan	Опан
opatija	Опатия
opicvet	Опицвет
opitsvet	Опицвет
opletnya	Оплетня
opulchenec	Опълченец
opulchenets	Опълченец
opulchensko	Опълченско
orach	Орач
oradea	Орадя
orania	Орания
oranjestad	Ораниестад
oranovo	Ораново
tsvetnitsa	Цветница
villeneuve	Вилньов
orekhovitsa	Ореховица
orekhovo	Орехово
orel	Орел
oreshak	Орешак
vrbica	Върбица
oreshari	Орешари
vuzel	Възел
oreshe	Ореше
oreshene	Орешене
subashka	Субашка
oreshino	Орешино
oreshitsa	Орещница
oresh	Ореш
oreshnik	Орешник
wlaschiza	Върбица
orizare	Оризаре
orizari	Оризари
orizovo	Оризово
orjakhovec	Оряховец
orjakhovica	Оряховица
orjakhovo	Оряхово
orlando	Орландо
orlandovtsi	Орландовци
orleans	Орлеан
orlica	Орлица
orlino	Орлино
orlintsi	Орлинци
orlitsa	Орлица
orljak	Орляк
orlovec	Орловец
orlovets	Орловец
orlovo	Орлово
sushitsa	Сушица
orlyak	Орляк
orlyane	Орляне
tsonkovtsi	Цонковци
ornicheto	Орничето
orolevite	Оролевите
orsha	Орша
orsoya	Орсоя
orti-makhala	Орти-Махала
ortsevo	Орцево
oryakhovets	Оряховец
oryakhovitsa	Оряховица
oryakhovo	Оряхово
sredsko	Средско
oselna	Оселна
osenarite	Осенарите
osenec	Осенец
osenets	Осенец
osen	Осен
osenovec	Осеновец
osenovets	Осеновец
osenovlag	Осеновлаг
staroselci	Староселци
osetenovo	Осетеново
oshane	Ошане
zdravec	Здравец
osh	Ош
oshtava	Ощава
osikata	Осиката
osikovica	Осиковица
vurbak	Върбак
osikovo	Осиково
osina	Осина
oskrushevo	Оскрушево
oslarka	Осларка
szekesfehervar	Секешфехервар
osmar	Осмар
osoica	Осоица
osoitsa	Осоица
tunkovo	Тънково
ostrava	Острава
ostrec	Острец
ostrets	Острец
ostrica	Острица
ostritsa	Острица
ostrokaptsi	Острокарци
ostrovche	Островче
zhivkovo	Живково
ostrovets	Островец
ostrovica	Островица
ostrovitsa	Островица
ostrov	Остров
ostrovo	Острово
oswiecim	Освиенцим
zlatolist	Златолист
oteshari	Отешари
otets-paisievo	Отец-Паисиево
yaounde	Яунде
ottawa	Отава
svode	Своде
ovchaga	Овчага
ovcharci	Овчарци
ovchari	Овчари
surnevo	Сърнево
ovchartsi	Овчарци
ovchepolci	Овчеполци
ovchepoltsi	Овчеполци
ovchevo	Овчево
oven	Овен
ovnartsi	Овнарци
ovoshhnik	Овощник
zebil	Зебил
ovoshtna	Овощтна
zheden	Жеден
oxford	Оксфорд
zadruga	Задруга
velikdenche	Великденче
padala	Падала
tsinga	Цинга
paderborn	Падерборн
valenciennes	Валансиен
padina	Падина
padine	Падине
zora	Зора
padova	Падуа
paisievo	Малко Паисиево
paisiy	Паисий
pajdushko	Пайдушко
palamarca	Паламарца
stozher	Стожер
palat	Палат
palatnik	Палатник
palatovo	Палатово
palauzovo	Палаузово
pale	Пале
yafo	Яфо
struya	Стуя
turnovtsi	Търновци
trakiec	Тракиец
palmdale	Палмдейл
pamidovo	Памидово
pamporovo	Пампорово
pamukchii	Памукчии
panagyurishte	Панагюрище
tsenovo	Ценово
panaretovci	Панаретовци
panaretovtsi	Панаретовци
panayot-khitovo	Панйот-Хитово
svetlik	Светик
pancharevo	Панчарево
panchevo	Панчево
pandutsite	Пандуците
panevezys	Паневежис
panicharevo	pancharevo
zimnica	Зимница
panicheri	Паничери
usoy	Усой
panichkovo	Паничково
panitsovo	Паницово
panovtsi	Пановци
papeete	Папеете
pappadhes	Попово село
paprat	Папрат
trier	Трир
vinograd	Виноград
paramaribo	Парамарибо
paramun	Парамун
parana	Парана
parapandovtsi	Парапандовци
vojvodino	Войводино
parchovtsi	Парчовци
parga	Парга
paril	Парил
paris	Париж
paritsa	Парица
parma	Парма
yovovtsi	Йововци
partizanin	Партизанин
pasadena	Пасадина
pasarel	Пасарел
pashinci	Пашинци
pashintsi	Пашинци
pashkul	Пашкул
pashovi	Пашови
yasen	Ясен
tupelo	Тюпело
paskalevec	Паскалевец
paskalevets	Паскалевец
topalite	Топалите
paspal	Паспал
pastir	Пастир
pastirtsi	Пастирци
pasto	Пасто
pastra	Пастра
pastukh	Пастух
pastusha	Пастуша
patalenica	Паталеница
patalenitsa	Паталеница
patica	Патица
patitsa	Патица
patrai	Патра
patreshko	Патршко
patresh	Патреш
patriarkh-evtimovo	Патриарх-Евтимово
paunovo	Пауново
paunovtsi	Пауновци
turnovca	Търновца
pavelsko	Павелско
pavlevtsi	Павлевци
pavlikeni	Павликени
pavlodar	Павлодар
pavlovoto	Павловото
pavolche	Паволче
payadzhi	Паяджи
paydushko	Пайдушко
pazarci	Пазарци
pazardzhik	Пазарджик
pazartsi	Пазарци
tursino	Търсино
yonchovo	Йончово
pchelari	Пчелари
uzundzhovo	Узунджово
pchelartsi	Пчеларци
pchelina	Пчелина
pchelin	Пчелин
pchelino	Пчелино
pchelinovo	Пчелиново
pchelishhe	Пчелище
pchelishte	Пчелище
pchelnik	Пчелник
pchelno	Пчелно
pechenica	Печеница
pechenitsa	Печеница
pechenyaga	Печеняга
pechinska	Печинска
pecs	Печ
peevsko	Пеевско
pejchinovo	Пейчиново
peje	Печ
pekhlivantsi	Пехливанци
pelatikovo	Пелатиково
vrbovka	Върбовка
pelishat	Пелишат
southampton	Саутхемптън
penk'ovtsi	Пенковци
penkovtsi	Пенковци
pen'ovo	Пеньово
pepelina	Пепелина
pepelishte	Пепелище
pepelka	Пепелка
perasma	Истраня
perilovets	Периловец
warsaw	Варшава
perlovtsi	Перловци
pernik	Перник
perperek	Перперек
perpignan	Перпинян
perth	Пърт
perunika	Перуника
perushtitsa	Перущица
pescia	Пеша
peshakovo	Пешаково
peshhersko	Пещерско
timarevo	Тимарево
peshterna	Пещерна
peshtersko	Пещерско
pesnopoj	Песнопой
pesnopoy	Песнопой
pesochnitsa	Песочница
pestnik	Пестник
pesucharka	Песъчарка
petelovo	Петелово
peteltsi	Петелци
peternica	Петърница
sondalo	Сондало
petkovtsi	Петковци
zub	Зъб
petlino	Петлино
petlite	Петлите
petokladenci	Петокладенци
petokladentsi	Петокладенци
petra	Петра
petrelik	Петрелик
yordanovo	Йорданово
petrich	Петрич
petrino	Петрино
petritch	Петрич
tjurkmen	Тюркмен
walsall	Уолсол
petrovdol	Петровдол
petrovitsa	Петровица
petrovo	Петрово
petrovtsi	Петровци
petrunovo	Петруново
petsovtsi	Пецовци
voyvodenets	Войводенец
peturnica	Петърница
petvar	Петвар
pevcite	Певците
pevets	Певец
pevtsite	Певците
peychinovo	Пейчиново
peykovtsi	Пейковци
veszprem	Веспрем
sredogriv	Средогрив
phatthaya	Патая
philadelphia	Филаделфия
phoenix	Финикс
pichor	Пичор
pijavec	Пиявец
pinsk	Пинск
piperevo	Пиперево
piperite	Пиперите
piperitsa	Пиперица
piperkovo	Пиперково
piraeus	Пирея
piramidata	Пирамидата
pirdop	Пирдоп
pirgovo	Пиргово
sturmen	Стърмен
pirin	Пирин
pirne	Пирне
vozhdovo	Виждово
pisa	Пиза
zvenimir	Звенимир
pisanets	Писанец
pisanitsa	Писаница
vinishhe	Винище
pisarevo	Писарево
svetlina	Светлина
pishhigovo	Пищигово
pishtane	Пищане
pishtigovo	Пищигово
pishtilska	Пищилска
pishurka	Пишурка
pismenovo	Писменово
pitesti	Питещ
tarkan	Таркан
pittsburgh	Питсбърг
pittsburg	Питсбърг
piyavets	Пиявец
pizzighettone	Пицигетоне
plachidol	Плачидол
plachka	Плачка
plachkovci	Плачковци
yerevan	Ереван
velentsi	Веленци
stuttgart	Щутгарт
plakuder	Плакудер
plana	Плана
planinata	Планината
planinec	Планинец
planinets	Планинец
planinica	Планиница
vetrishhe	Ветрище
planinovo	Планиново
planintsi	Планинци
vladikavkaz	Владикавказ
plazishhe	Плазище
plazishte	Плажище
plazovets	Плазовец
vinci	Винчи
plenimir	Пленимир
pleshintsi	Плешинци
teteven	Тетевен
pleshivets	Плешивец
pletena	Плетена
pleven	Плевен
vranilovci	Враниловци
pliska	Плиска
plodovitovo	Плодовитово
ploiesti	Плоещ
ploski	Плоски
yavorovets	Яворовец
plovdiv	Пловдив
plovdivtsi	Пловдивци
plovka	Пловка
vidno	Видно
pluzishte	Плъжище
plzen	Пилзен
pobeda	Мансърлии
pochivalo	Почивало
podajva	Подайва
podayva	Подайва
podem	Подем
podgorec	Подгорец
podgore	Подгоре
zlatiya	Златия
zlatusha	Златуша
podgorie	Подгорие
podgoritsa	Подгорица
podgumer	Подгумер
podkova	Подкова
podkrepa	Подкрепа
podles	Подлес
podrumche	Подрумче
sratsimirovo	Страцимирово
solnik	Солник
podvrukh	Подвръх
pogledets	Погледец
poibrene	Поибрене
poitiers	Поатие
pokrajna	Покрайна
pokrayna	Покрайна
pokrovan	Покрован
pokrovnik	Покровник
polaten	Полатен
polatovo	Полатово
polena	Полена
polenica	Поленица
polenitsa	Поленица
poletintsi	Полетинци
poletkovtsi	Полетковци
soyka	Сойка
zaimchevo	Заимчево
polikrayshte	Поликраище
poliovtsi	Полиовци
poljacite	Поляците
poljana	Поляна
zvezdica	Звездица
polkovnik-cholakovo	Полковник-Чолаково
polkovnik-dyakovo	Полковник-Дяково
polkovnik-lambrinovo	Полковник-Ламбриново
vodna	Водна
polkovnik-taslakovo	Полковник-Таслаково
poltava	Полтава
polyana	Поляна
turkmenabat	Туркменабат
polyanovo	Поляново
polyantsi	Полянци
taban	Табан
pomen	Помен
pomezhdin	Помеждин
zakopane	Закопане
pomoshhnik	Помощник
pomoshtitsa	Помощница
stamboliyski	Стамболийски
tochilartsi	Точиларци
popari	Попари
zmievo	Змиево
studenitsa	Студеница
popgrigorovo	Попгригорово
popgruevo	Попгруево
wuerzburg	Вюрцбург
popina	Попина
popinci	Попинци
popintsi	Попинци
popitsa	Попица
stanevo	Станево
syartsi	Сярци
popovci	Поповци
popovec	Поповец
tsarevtsi	Царевци
ulumska	Улумска
popovich	Попович
popovitsa	Поповица
popovjane	Поповяне
voronezh	Воронеж
popovska	Поповска
popovtsi	Поповци
popovyane	Поповяне
popraykovtsi	Попрайковци
poprelka	Попрелка
todorovo	Тодорово
popska	Попска
popsko	Попско
pordim	Пордим
trepeskovtsi	Трепесковци
poroishte	Арнаут
poroj	Порой
porojno	Поройно
porominovo	Пороминово
poroy	Порой
poroyna	Поройна
tunkoto	Тънкото
port-au-prince	Порт о Пренс
port-gentil	Порт Жантил
portitovci	Портитовци
portitovtsi	Портитовци
portland	Портланд
vulchovtsi	Вълчовци
todor-ikonomovo	Тодор-Икономово
poruchik-chunchevo	Поручик-Чунчево
poruchik-kurdzhievo	Поручик-Кърджиево
posabina	Посабина
posadas	Посадас
posev	Посев
poshevo	Пошево
positano	Позитано
possagno	Посаньо
postnik	Постник
potamoi	Борово
potocharka	Поточарка
potoche	Поточе
potochnica	Поточница
potochnitsa	Поточница
trunarka	Трънарка
potok	Поток
potop	Потор
stakevtsi	Стакевци
spasovska	Спасовска
povaliruzh	Повалиръж
povelyanovo	Повеляново
povet	Повет
povien	Повиен
pozharevo	Пожарево
pozhernik	Пожерник
split	Сплит
pozzuoli	Поцуоли
prague	Прага
praiano	Праяно
prakhalite	Прахалите
prakhavitsa	Прахавица
prakhovo	Прахово
yagnilo	Ягнило
pravda	Правда
pravdino	Правдино
pravdoljub	Правдолюб
pravdolyub	Правдолюб
zhitnica	Житница
pravets	Правец
pravishhe	Правище
pravishte	Правище
vlechugovo	Влечугово
pravoslaven	Православен
pravoslav	Православ
prekolnitsa	Преколница
tulcea	Тулча
prelez	Прелез
prelom	Прелом
preobrazhenci	Преображенци
preobrazhentsi	Преображенци
preseka	Пресека
preselec	Преселец
preselenci	Преселенци
preselentsi	Преселенци
staevtsi	Стаевци
preselka	Преселка
trifonovo	Трифоново
presiyan	Пресиян
varnenci	Варненци
preslavci	Преславци
preslaven	Преславен
preslavets	Преславец
preslavtsi	Преславци
tipchenitsa	Типченица
prespa	Преспа
prestoy	Престой
presyaka	Пресяка
teshovo	Тешово
pretoria	Претория
prevala	Превала
prezhda	Прежда
priboy	Прибой
pridvoritsa	Придворица
prilepci	Прилепци
prilep	Прилеп
prileptsi	Прилепци
turnoslivka	Търносливка
yastrebovo	Ястребово
pripechene	Припечене
tikhovets	Тиховец
prisadets	Присадец
prisad	Присад
svidnja	Свидня
priseltsi	Приселци
prisoeto	Присоето
prisovo	Присово
prisoyna	Присойна
pristan	Пристан
pristina	Прищина
pristoe	Пристое
probuda	Пробуда
prodancha	Проданча
srunsko	Срънско
prodanovtsi	Продановци
prodimchets	Продимчец
profesor-ishirkovo	Професор-Иширково
progled	Проглед
prokhlada	Прохлада
prokhod	Проход
vulchitrun	Вълчитрън
vetovo	Ветово
prolaznitsa	Пролазница
prolesha	Пролеша
prolez	Пролез
prolom	Пролом
propast	Пропаст
todoretsite	Тодореците
prosena	Просена
prosenik	Просеник
proslav	Прослав
prostorno	Просторно
protopopintsi	Протопопинци
provadiya	Провадия
provalenitsa	Проваленица
providence	Провидънс
trepetlika	Трепетлика
pryaporets	Пряпорец
pshenichevo	Пшеничево
ptichari	Птичари
spa	Спа
sredishtna	Средищна
ptolemais	Кайляри
pudarevo	Пъдарево
pudarino	Пъдарино
tserkovski	Церковски
pudartsi	Пъдарци
pudrija	Пудрия
pudriya	Пудрия
pultusk	Пултуск
yastrebino	Ястребино
punevo	Пънево
pungovtsi	Пунговци
purchovtsi	Пърчовци
tyanovo	Тяново
purmerend	Пюрмеренд
purovtsi	Пъровци
pursha	Пърша
purtevtsi	Пъртевци
purvan	Първан
purvenec	Първенец
zasele	Заселе
zelenikovo	Зелениково
purvitsa	Първица
straldzha	Стралджа
purvomaj	Първомай
purvomay	Първомай
purvomaytsi	Първомайци
purzhigrakh	Пържикрак
pusan	Пусан
pushevo	Пушево
toronto	Торонто
pustrogor	Пъстрогор
pustrook	Пъстрок
pustrovo	Пъстрово
putnikovo	Пътниково
pyasuchevo	Пясъчник
pyasuchnik	Пясъчник
pyatigorsk	Пятигорск
vinica	Виница
upchovskoto	Упчовското
rabat	Рабат
rabisha	Рабиша
venkovtsi	Венковци
rabrovo	Раброво
rachevtsi	Рашевци
rachovtsi	Рашовци
racine	Расийн
rada	Рада
tsonevo	Цонево
radanovo	Раданово
radantsi	Раданци
radecki	Радецки
radetski	Радецки
radevo	Радево
radevtsi	Радевци
stomanetsite	Стоманеците
todorovtsi	Тодоровци
radilovo	Радилово
radingrad	Радинград
radinka	Радинка
terzijsko	Терзийско
vulchidol	Вълчидол
radishevo	Радишево
radjuvene	Радювене
radkovtsi	Радковци
radlovtsi	Радловци
radnevo	Раднево
radnevtsi	Радневци
radoevskoto	Радоевското
radoevtsi	Радоевци
vulkovich	Вълкович
radomir	Радомир
radomirtsi	Радомирци
vrabchevtsi	Врабчевци
radotina	Радотина
tsiklovo	Циклово
radovene	Радовене
radovets	Радовец
radovo	Радово
radovtsi	Радовци
radoykovo	Радойково
radoynovo	Радойново
vilare	Виларе
radulovtsi	Радуловци
raduntsi	Радунци
raduy	Радю
raetska	Раешка
raevtsi	Раевци
raiding	Райдинг
winchester	Уинчестър
rajovo	Райово
rakevo	Ракево
rakhovtsi	Раховци
rakilovtsi	Ракиловци
rakita	Ракита
rakitna	Ракитина
rakitnica	Ракитница
rakitnitsa	Ракитница
rakitovo	Ракитово
raklinovo	Раклиново
raklitsa	Раклица
rakovica	Раковица
tluchnitsite	Тлъчниците
rakovo	Раково
zhelud	Желъд
rakovskovo	Раковсково
rakowez	Гроздьово
ralchovska	Ралховска
ralevo	Ралево
ralevtsi	Ралевци
somalia	Сомалия
ralinovtsi	Ралиновци
ralitsa	Ралица
vodenci	Воденци
rangoon	Янгон
ranintsi	Ранинци
ranitsa	Раница
velchevska	Велчевска
rashevtsi	Рашевци
rashkovo	Рашково
rashovite	Рашовите
rashovitsa	Рашовица
zurnevo	Зурнево
trunkovo	Трънково
rastnik	Растник
ravadinovo	Равадиново
ravda	Равда
ravello	Равело
raven	Равен
ravenna	Равена
vuglevtsi	Въглевци
ravnec	Равнец
ravnets	Равнец
ravnil	Равнил
tirano	Тирано
tishevitsa	Тишевица
stoykovo	Стойково
stanyantsi	Станянци
ravnogor	Равногор
srednogorie	Средногорие
ravnovo	Равново
rayanovtsi	Раяновци
rayantsi	Раянци
raykovo	Райково
raykovska	Райковска
srnevec	Сърневец
raylovo	Райлово
raynezh	Райнеж
visokite	Високите
raynovo	Райново
raynovtsi	Райновци
raynushkovtsi	Райнушковци
rayovo	Райово
rayuvtsi	Раювци
spoluka	Сполука
razbojna	Разбойна
razboyna	Разбойна
zelenika	Зеленика
razdel	Раздел
razdelna	Разделна
razdeltsi	Разделци
razdolata	Раздолата
razdol	Раздол
razgrad	Разград
razhdavica	Раждавица
razhdavitsa	Ръждавица
razhishte	Ръжище
razliv	Разлив
razlog	Разлог
razpopovtsi	Разпоповци
razsokha	Разсоха
razvalatsi	Резвалаци
razvigorovo	Развигорово
reading	Рединг
rebrevtsi	Ребревци
rebro	Ребро
rebrovo	Реброво
reburkovo	Ребърково
vodnyanka	Воднянка
rechani	Речани
uvurolan	Увуролан
vranjak	Враняк
zlatar	Златар
redeshkovtsi	Редешковци
redina	Редина
redova	Редова
vienna	Виена
vinogradi	Виногради
rekichka	Рекичка
rel'ovo	Рельово
treskavec	Трескавец
reno	Рино
repljana	Репляна
tsaratsovo	Царацово
yalta	Ялта
reselets	Реселец
zvunichevo	Звъничево
resilovo	Ресилово
resistencia	Ресистенсия
vruv	Връв
reyanovtsi	Реяновци
reykjavik	Рейкявик
rezach	Резач
zgalevo	Згалево
wroclaw	Вроцлав
rezhantsi	Режанци
rezhintsi	Режинци
rezovo	Резово
ribarica	Рибарица
ribaritsa	Рибарица
ribartsi	Рибарци
riben	Рибен
ribino	Рибино
sondrio	Сондрио
ribnik	Рибник
ribnitsa	Рибница
ribnovo	Рибново
todyuvtsi	Тодювци
ridino	Ридино
ridovo	Ридово
riga	Рига
rijeka	Риека
rila	Рила
rilci	Рилци
riltsi	Рилци
rish	Риш
risimanovo	Рисиманово
risnov	Ръшнов
ritya	Ритя
riverside	Ривърсайд
riyadh	Рияд
rjakhovcite	Ряховците
rjakhovo	Ряхово
robino	Робино
robovo	Робово
rochester	Рочестър
rodina	Родина
valeto	Валето
rodopsko	Родопско
rogachevo	Рогачево
rogach	Рогач
roglets	Роглец
rogosh	Рогош
rogozari	Рогозари
rogozche	Рогозче
strazhevtsi	Стражевци
rogozina	Рогозина
rogozinovo	Рогозиново
rogulyat	Рогулят
rojak	Рояк
rokhleva	Рохлева
villeblevin	Вилблевен
romania	Румъния
roman	Роман
ropolska	Рополска
volovartsi	Воловарци
rosario	Росарио
veslets	Веслец
rosenovo	Росеново
rosica	Росица
rosina	Розина
rositsa	Росица
rosno	Росно
rosoman	Розоман
rostock	Росток
rostov-na-donu	Ростов на Дон
rotterdam	Ротердам
urbino	Урбино
roussalka	Камен бряг
zlatevtsi	Златевци
royak	Рояк
roza	Роза
rozhden	Рожден
rozhen	Рожен
rozino	Розино
rozovec	Розовец
vasil'ovo	Васильово
rozovo	Розово
zavidovtsi	Завидовци
ruchey	Ръчей
ruda	Руда
rudarci	Рударци
rudartsi	Рударци
swinoujscie	Свиоуйсцие
rudney	Рудней
venec	Венец
tyulenovo	Тюленово
rudozem	Рудозем
ufa	Уфа
ruen	Руен
ruets	Руец
ruevtsi	Руевци
rujno	Руйно
rukhovtsi	Руховци
rumanya	Румъния
rumeliya	Румелия
rumjancevo	Румянцево
rumyantsevo	Румянцево
runya	Руня
rupcha	Рупча
rupci	Рупци
rupite	Рупите
rupkite	Рупките
zimzelen	Зимзелен
rusalina	Русалина
rusalja	Русаля
zadar	Задар
rusalya	Русаля
yakima	Якима
rusevtsi	Русевци
rusinovtsi	Русиновци
ruskovtsi	Русковци
rusokastro	Русокастро
rusovo	Ръсово
rustan	Рустан
rust'avi	Рустави
rut	Рът
rutlina	Рътлина
ruychovtsi	Руйчовци
ruyno	Руйно
ruzhana	Ръжана
ruzhavets	Ръжавец
ruzhdak	Ръждак
ruzhena	Ръжена
ruzhenovo	Ръженово
trustenik	Тръстеник
ruzhica	Ружица
versailles	Версай
ruzhitsa	Ружица
ryakhovo	Ряхово
ryakhovtsite	Ряховците
ryaskovtsi	Рясковци
vaduz	Вадуц
saarbrucken	Саарбрюкен
saarland	Саарланд
sacramento	Сакраменто
stubel	Стубел
ugledno	Угледно
sadovets	Садовец
sadovik	Садовик
sadovitsa	Садовица
sadovo	Садово
sadukovtsi	Садъковци
saint-barthelemy	Сен Бартелеми
vojvodovo	Войводово
starcevo	Старцево
saint-martin	Сен Мартен
vodach	Водач
salash	Салаш
strjama	Стряма
salem	Салем
salerno	Салерно
salisbury	Солсбъри
salmanovo	Салманово
salta	Салта
salzburg	Залцбург
samara	Самара
samarqand	Самарканд
samodiva	Самодива
stamovo	Стамово
zmeevo	Змеево
samoranovo	Самораново
samotino	Самовитино
willemstad	Вилемстад
ukhlovitsa	Ухловица
samsiite	Самците
samuil	Самуил
zhrebino	Жребино
sanadinovo	Санадиново
sandanski	Сандански
zheludovo	Желъдово
zimnishte	Зимнище
zagrazhden	Загражден
yabulkovets	Ябълковец
saraevo	Сараево
vermont	Върмънт
saraja	Сарая
sarajevo	Сараево
sarande	Саранда
saranite	Сараните
saransko	Саранско
sarantsi	Саранци
saraya	Сарая
sarnac	Сърнак
sarovtsi	Саровци
sashevo	Сашево
satovcha	Сатовча
sausalito	Саусалито
sava	Сава
savchovtsi	Савчовци
savin	Савин
savino	Савино
savonlinna	Савонлина
savoyski	Савойски
sazhdenik	Сажденик
sazhdevo	Саждево
szekszard	Сексард
sborishhe	Сборище
sborishte	Сборище
zlitrap	Злитрап
scala	Скала
scarborough	Скарбъро
schengen	Шенген
schruns	Шрунс
schwerin	Шверин
sciacca	Шака
seattle	Сиатъл
syarovtsi	Сяровци
yankovo	Янково
sedelets	Седелец
sedlarevo	Седларево
stefan-karadzhovo	Стефан-Караджово
sedlartsi	Седларци
sedlovina	Седловина
sedyankovtsi	Седянковци
sejdol	Сейдол
topchiysko	Топчийско
sekirovo	Секирово
vel'ovo	Вельово
selanovci	Селановци
selanovtsi	Селановци
selcha	Селча
selci	Селци
seliminovo	Селиминово
selishhe	Селище
selishte	Селище
yantra	Янтра
seltse	Селце
seltsi	Селци
veselina	Веселина
selyank	Селянк
vidritsa	Видрица
semchinovo	Семчиново
zhrebevo	Жребево
tselina	Целина
semertsi	Семерци
vitsyebsk	Витебск
sennik	Сенник
senoklas	Сеноклас
senokos	Сенокос
senovo	Сеново
sentse	Сенце
seoul	Сеул
septemvrijci	Септемврийци
septemvri	Септември
septemvriytsi	Септемврийци
serbia	Сърбия
sergyuvets	Сергювец
serres	Сяр
seslav	Сеслав
seslavtsi	Сеславци
sestrimo	Сестримо
sestrino	Сестрино
yalovitsa	Яловица
sevar	Севар
sreditsa	Средица
sevdalina	Севдалина
severci	Северци
tsalapitsa	Цалапица
zidartsi	Зидарци
stokite	Стоките
sevilla	Севиля
sevketiye	Хаджи Паун
sevlievo	Севлиево
seyachi	Сейчани
seydol	Сейдол
seykovtsi	Сейковци
seymenite	Сеймените
shabla	Шабла
toulouse	Тулуза
shanovo	Шаново
sharanite	Шараните
sharbanska	Шарбанска
sharennos	Шареннос
sharenska	Шаренска
sharjah	Шаржа
srednja	Средня
sharotintsi	Шаротинци
shashintsi	Шашинци
stoynovskoto	Стойновското
zvezdelina	Звезделина
vukovo	Вълково
sheffield	Шефилд
shejnovo	Шейново
shekhtova	Шехтова
shemshevo	Шемшево
shenini	Шенини
tserovitsa	Церовица
sheremetovo	Шереметово
vaklova	Ваклова
sheynovo	Шейново
shhruklevo	Щръклево
shhurkovo	Щърково
shijakovo	Шияково
shijiazhuang	Шидзяджуан
shiliveri	Шиливери
shilkovtsi	Шилковци
velchovtsi	Велчовци
shipka	Шипка
shipkovitsa	Шипковица
shipkovo	Шипково
zdravchets	Здравчец
shipochano	Шипочано
shipok	Шипок
voysil	Войсил
shirokovo	Широково
yovchovtsi	Йовчовци
shishkovci	Шишковци
shishkovitsa	Шишковица
shishkovtsi	Шишковци
tsutsumanite	Цуцуманите
shishmanovo	Шишманово
shishmantsi	Шишманци
shivachevo	Шивачево
shivarovo	Шиварово
shiyakovo	Шияково
shiyakovtsi	Шияковци
shkoder	Шкодра
shkorpilovci	Шкорпиловци
shkorpilovtsi	Шкорпиловци
shodekovtsi	Шодековци
shondrovi	Шондрови
shopci	Шопци
shopite	Шопите
yovkovo	Йовково
vodica	Водица
shterna	Щерна
shtip	Щип
shtipsko	Щипско
shtit	Щит
zvunets	Звънец
volujak	Волуяк
shturkovo	Щърково
shubetsi	Шубеци
shuglevtsi	Шуглевци
shumaka	Шумака
shuma	Шума
shumanska	Шуманска
velkovci	Велковци
shumeli	Шумели
trigrad	Триград
shumenci	Шуменци
shumen	Шумен
vishegrad	Вишерград
shumnatica	Шумнатица
shumnatitsa	Шумнатица
shushnya	Шушня
siauliai	Шяуляй
sibiu	Сибиу
sidhironeron	Осеница
tbilisi	Тбилиси
siegen	Зиген
siena	Сиена
sighisoara	Сигишоара
sigmen	Сигмен
yoglav	Йоглав
silen	Силен
silistra	Силистра
simeonovec	Симеоновец
simeonovets	Симеоновец
simeonovgrad	Симеоновград
simeonovo	Симеоново
svobodinovo	Свободиново
simitli	Симитли
sinagovci	Синаговци
visino	Висино
sinapovo	Синапово
sinchec	Синчец
sinchets	Синчец
sindelci	Синделци
sindel	Синдел
sindeltsi	Синделци
tokorozawa	Токоросава
sinemorets	Синеморец
yasenovets	Ясеновец
sinitovo	Синитово
surnegor	Сърнегор
sipej	Сипей
sipets	Сипец
sipey	Сипей
sirakovo	Сираково
siratsite	Сираците
sirishhnik	Сирищник
zaburdo	Забърдо
sirmanite	Сирманите
zarnik	Зарник
sivino	Сивино
sivogushka	Сивогушка
skalak	Скалак
tsurnel	Църнел
skalica	Скалица
skalina	Скалина
skalishhe	Скалище
voynovo	Войново
skalitsa	Скалица
skaloti	Либан
skalsko	Скалско
skandaloto	Скандалото
sklave	Склаве
skobelevo	Скобелево
skomlya	Скомля
skopje	Скопие
skorets	Скорец
skortsite	Скорците
vlasatili	Власатили
skrebatno	Скребатно
skributna	Скрибътна
skrino	Скрино
skrinyano	Скриняно
skrut	Скрът
skurbino	Скърбино
skurvenskoto	Скървенското
skutare	Скутаре
stancha	Станча
trakija	Тракия
slakovci	Слаковци
veshtitsa	Вещица
slamino	Сламино
slanotrun	Сланотрън
slashhen	Слащен
slashten	Слащен
slatina	Слатина
slatino	Слатино
topolnitsa	Тополница
slaveevo	Славеево
vulchanovo	Вълчаново
slavejkovo	Славейково
veselin	Веселин
slavjanci	Славянци
slavjani	Славяни
slavjanovo	Славяново
zamukhovo	Замухово
slavotin	Славотин
targoviste	Търговище
slavovitsa	Славовица
slavovtsi	Славовци
slavshtitsa	Славщица
slavyani	Славяни
slavyanin	Слвянин
slavyanovo	Славяново
zabernovo	Заберново
sligo	Слайгоу
slishovtsi	Слишовци
slivak	Сливак
slivarka	Сливарка
slivarovo	Сливарово
slivarska	Сливарска
slivata	Сливата
slivek	Сливек
sliven	Сливен
sliventsi	Сливенци
slivito	Сливито
taipei	Тайпей
vishnevo	Вишево
visoka	Висока
slivnitsa	Сливница
vranino	Вранино
tivoli	Тиволи
slivovnik	Сливовник
slivovo	Сливово
slokoshhica	Слокощица
slokoshtitsa	Слокошица
slomer	Сломер
slunchevo	Слънчево
slunchogled	Слънчоглед
slunchovets	Слънчовец
smilec	Смилец
troitsa	Троица
smiljan	Смилян
smilovtsi	Смиловци
smilyan	Смилян
smin	Смин
smirnenski	Смирненски
smirnentsi	Смирненци
smochan	Смочан
smochevo	Смочево
smolcha	Смолча
smolensk	Смоленск
vedrina	Ведрина
yasnets	Яснец
smolichano	Смоличано
vladaja	Владая
svirtsi	Свирци
vojnegovci	Войнеговци
smolnitsa	Смолница
smolsko	Смолско
smolyan	Смолян
stanovets	Становец
smurdan	Смърдан
voynegovtsi	Войнеговци
strumeshnitsa	Струмешница
snezha	Снежа
strupets	Струпец
snezhinka	Снежинка
svoboditsa	Свободица
snop	Сноп
snyagovo	Снягово
sotirovo	Сотирово
soedertaelje	Сьодертале
sofia	София
starovo	Старово
sofronievo	софрониево
sokhumi	Сухуми
sokolarci	Соколарци
sokolare	Соколаре
sokolartsi	Соколарци
sokolec	Соколец
sokolentsi	Соколенци
sokolets	Соколец
sokolica	Соколица
sokolino	Соколино
sokolite	Соколите
temska	Темска
sokoljane	Соколяне
zdravkovets	Здравковец
